release_date,release_year,movie,production_budget,domestic_gross,foreign_gross,worldwide_gross
"Dec 18, 2009",2009,Avatar,425000000,760507625,2015837654,2776345279
"May 20, 2011",2011,Pirates of the Caribbean: On Stranger Tides,410600000,241063875,804600000,1045663875
"Jun 7, 2019",2019,Dark Phoenix,350000000,42762350,107000000,149762350
"May 1, 2015",2015,Avengers: Age of Ultron,330600000,459005868,944008095,1403013963
"Dec 15, 2017",2017,Star Wars Ep. VIII: The Last Jedi,317000000,620181382,696540365,1316721747
"Dec 18, 2015",2015,Star Wars Ep. VII: The Force Awakens,306000000,936662225,1116648995,2053311220
"Apr 27, 2018",2018,Avengers: Infinity War,300000000,678815482,1369318718,2048134200
"May 24, 2007",2007,Pirates of the Caribbean: At Worldâs End,300000000,309420425,654000000,963420425
"Nov 17, 2017",2017,Justice League,300000000,229024295,426920914,655945209
"Nov 6, 2015",2015,Spectre,300000000,200074175,679546748,879620923
"Jul 20, 2012",2012,The Dark Knight Rises,275000000,448139099,636300000,1084439099
"May 25, 2018",2018,Solo: A Star Wars Story,275000000,213767512,179383835,393151347
"Jul 2, 2013",2013,The Lone Ranger,275000000,89302115,170700000,260002115
"Mar 9, 2012",2012,John Carter,275000000,73058679,209719421,282778100
"Nov 24, 2010",2010,Tangled,260000000,200821936,385655304,586477240
"May 4, 2007",2007,Spider-Man 3,258000000,336530303,558329927,894860230
"May 6, 2016",2016,Captain America: Civil War,250000000,408084349,731985064,1140069413
"Mar 25, 2016",2016,Batman v Superman: Dawn of Justice,250000000,330360194,537140087,867500281
"Dec 14, 2012",2012,The Hobbit: An Unexpected Journey,250000000,303003568,714000000,1017003568
"Jul 15, 2009",2009,Harry Potter and the Half-Blood Prince,250000000,302089278,633124489,935213767
"Dec 13, 2013",2013,The Hobbit: The Desolation of Smaug,250000000,258366855,702000000,960366855
"Dec 17, 2014",2014,The Hobbit: The Battle of the Five Armies,250000000,255119788,690457833,945577621
"Apr 14, 2017",2017,The Fate of the Furious,250000000,225764765,1009081502,1234846267
"Jun 28, 2006",2006,Superman Returns,232000000,200120000,173965065,374085065
"May 26, 2017",2017,Pirates of the Caribbean: Dead Men Tell No Tales,230000000,172558876,615682261,788241137
"Nov 14, 2008",2008,Quantum of Solace,230000000,169368427,422323651,591692078
"May 4, 2012",2012,The Avengers,225000000,623279547,894656350,1517935897
"Jul 7, 2006",2006,Pirates of the Caribbean: Dead Manâs Chest,225000000,423315812,642900000,1066215812
"Jun 14, 2013",2013,Man of Steel,225000000,291045518,376954000,667999518
"May 16, 2008",2008,The Chronicles of Narnia: Prince Caspian,225000000,141621490,275719798,417341288
"Jul 3, 2012",2012,The Amazing Spider-Man,220000000,262030663,495859604,757890267
"May 18, 2012",2012,Battleship,220000000,65233400,248244317,313477717
"Jun 21, 2017",2017,Transformers: The Last Knight,217000000,130168683,472724657,602893340
"Jun 12, 2015",2015,Jurassic World,215000000,652270625,996584239,1648854864
"May 25, 2012",2012,Men in Black 3,215000000,179020854,475192631,654213485
"Jun 24, 2009",2009,Transformers: Revenge of the Fallen,210000000,402111870,434407829,836519699
"Jun 27, 2014",2014,Transformers: Age of Extinction,210000000,245439076,858600000,1104039076
"May 26, 2006",2006,X-Men: The Last Stand,210000000,234362462,224898484,459260946
"May 14, 2010",2010,Robin Hood,210000000,105487148,216971858,322459006
"Dec 14, 2005",2005,King Kong,207000000,218080025,332437332,550517357
"Dec 7, 2007",2007,The Golden Compass,205000000,70107728,297154830,367262558
"Feb 16, 2018",2018,Black Panther,200000000,700059566,648198658,1348258224
"Dec 19, 1997",1997,Titanic,200000000,659363944,1548844451,2208208395
"Jun 15, 2018",2018,Incredibles 2,200000000,608581744,633938967,1242520711
"Dec 16, 2016",2016,Rogue One: A Star Wars Story,200000000,532177324,516925532,1049102856
"Jun 17, 2016",2016,Finding Dory,200000000,486295561,534919632,1021215193
"Jun 18, 2010",2010,Toy Story 3,200000000,415004880,653874642,1068879522
"May 3, 2013",2013,Iron Man 3,200000000,408992272,806400000,1215392272
"May 5, 2017",2017,Guardians of the Galaxy Vol 2,200000000,389813101,472503132,862316233
"Jun 30, 2004",2004,Spider-Man 2,200000000,373524485,421586185,795110670
"Mar 5, 2010",2010,Alice in Wonderland,200000000,334191110,691300000,1025491110
"Nov 8, 2012",2012,Skyfall,200000000,304360277,806166704,1110526981
"Jun 21, 2013",2013,Monsters University,200000000,268488329,475100000,743588329
"Mar 8, 2013",2013,Oz the Great and Powerful,200000000,234770996,255588055,490359051
"May 23, 2014",2014,X-Men: Days of Future Past,200000000,233921534,513941241,747862775
"May 2, 2014",2014,The Amazing Spider-Man 2,200000000,202853933,506142403,708996336
"Jun 24, 2011",2011,Cars 2,200000000,191450875,368704508,560155383
"Dec 17, 2010",2010,Tron: Legacy,200000000,172062763,228000000,400062763
"Nov 13, 2009",2009,2012,200000000,166112167,591565581,757677748
"Nov 16, 2018",2018,Fantastic Beasts: The Crimes of Grindelwald,200000000,159555901,492664185,652220086
"May 21, 2009",2009,Terminator Salvation,200000000,125322469,240169323,365491792
"Jun 17, 2011",2011,Green Lantern,200000000,116601172,102934320,219535492
"May 28, 2010",2010,Prince of Persia: Sands of Time,200000000,90759676,245600000,336359676
"Jun 29, 2011",2011,Transformers: Dark of the Moon,195000000,352390543,771400000,1123790543
"Jun 9, 2017",2017,The Mummy,195000000,80101125,329852780,409953905
"Mar 1, 2013",2013,Jack the Giant Slayer,195000000,65187603,132500000,197687603
"Apr 3, 2015",2015,Furious 7,190000000,353007020,1165715774,1518722794
"May 16, 2013",2013,Star Trek Into Darkness,190000000,228778661,238602923,467381584
"Jun 21, 2013",2013,World War Z,190000000,202359711,329154939,531514650
"May 10, 2013",2013,The Great Gatsby,190000000,144840419,206200000,351040419
"Nov 6, 2009",2009,Disneyâs A Christmas Carol,190000000,137855863,177853834,315709697
"Jul 12, 2013",2013,Pacific Rim,190000000,101802906,309200000,411002906
"Nov 25, 2015",2015,The Good Dinosaur,187500000,123087120,210683917,333771037
"May 2, 2008",2008,Iron Man,186000000,318604126,266567421,585171547
"Jul 18, 2008",2008,The Dark Knight,185000000,533720947,468275260,1001996207
"May 22, 2008",2008,Indiana Jones and the Kingdom of the Crystal Skull,185000000,317101119,469534294,786635413
"Jun 22, 2012",2012,Brave,185000000,237282182,317324350,554606532
"Mar 10, 2017",2017,Kong: Skull Island,185000000,168052812,393019247,561072059
"Jul 22, 2016",2016,Star Trek Beyond,185000000,158848340,176953893,335802233
"Oct 6, 2017",2017,Blade Runner 2049,185000000,92054159,167303249,259357408
"May 24, 2019",2019,Aladdin,182000000,246734314,372500000,619234314
"Nov 3, 2017",2017,Thor: Ragnarok,180000000,315058289,531921735,846980024
"Dec 9, 2005",2005,"The Chronicles of Narnia: The Lion, the Witch and the Wardrobe",180000000,291710957,428828615,720539572
"May 30, 2014",2014,Maleficent,180000000,241407328,517129407,758536735
"Nov 18, 2016",2016,Fantastic Beasts and Where to Find Them,180000000,234037575,568365278,802402853
"Jun 27, 2008",2008,WALL-E,180000000,223808164,308699861,532508025
"Aug 10, 2007",2007,Rush Hour 3,180000000,140125968,116459914,256585882
"Jul 1, 2016",2016,The Legend of Tarzan,180000000,126643061,222258964,348902025
"Nov 23, 2011",2011,Hugo,180000000,73864507,106183277,180047784
"Jul 21, 2017",2017,Valerian and the City of a Thousand Planets,180000000,40479370,174618986,215098356
"Feb 6, 2015",2015,Jupiter Ascending,179000000,47482519,134500000,181982519
"Jul 27, 2018",2018,Mission: ImpossibleâFallout,178000000,220159104,567297448,787456552
"May 27, 2016",2016,X-Men: Apocalypse,178000000,155442489,387095057,542537546
"Aug 10, 2018",2018,The Meg,178000000,145443742,384086973,529530715
"Jun 6, 2014",2014,Edge of Tomorrow,178000000,100206256,270335000,370541256
"Mar 8, 2019",2019,Captain Marvel,175000000,426525952,696535598,1123061550
"Apr 15, 2016",2016,The Jungle Book,175000000,364001123,598853424,962854547
"Jun 19, 2015",2015,Inside Out,175000000,356461711,497774281,854235992
"Jul 7, 2017",2017,Spider-Man: Homecoming,175000000,334201140,545965210,880166350
"Aug 5, 2016",2016,Suicide Squad,175000000,325100054,420959833,746059887
"May 29, 2009",2009,Up,175000000,293004164,438459213,731463377
"Nov 22, 2017",2017,Coco,175000000,209726015,588282086,798008101
"Nov 21, 2018",2018,Ralph Breaks The Internet,175000000,201091711,323191984,524283695
"Mar 27, 2009",2009,Monsters vs. Aliens,175000000,198351526,183335854,381687380
"Jun 16, 2017",2017,Cars 3,175000000,152901115,230640254,383541369
"Aug 7, 2009",2009,G.I. Joe: The Rise of Cobra,175000000,150201498,152267519,302469017
"Jun 30, 1999",1999,Wild Wild West,175000000,113805681,107423654,221229335
"Aug 1, 2008",2008,The Mummy: Tomb of the Dragon Emperor,175000000,102491776,303268449,405760225
"Jun 22, 2007",2007,Evan Almighty,175000000,100289690,73841639,174131329
"Jul 28, 1995",1995,Waterworld,175000000,88246220,176000000,264246220
"May 12, 2017",2017,King Arthur: Legend of the Sword,175000000,39175066,100455270,139630336
"Dec 25, 2013",2013,47 Ronin,175000000,38362475,113354340,151716815
"Jun 22, 2018",2018,Jurassic World: Fallen Kingdom,170000000,417719760,888053039,1305772799
"Aug 1, 2014",2014,Guardians of the Galaxy,170000000,333172112,437695404,770867516
"May 7, 2010",2010,Iron Man 2,170000000,312433331,308723058,621156389
"Apr 4, 2014",2014,Captain America: The Winter Soldier,170000000,259746958,454654931,714401889
"Jul 11, 2014",2014,Dawn of the Planet of the Apes,170000000,208545589,502098977,710644566
"Nov 10, 2004",2004,The Polar Express,170000000,187224605,124140582,311365187
"Jun 1, 2012",2012,Snow White and the Huntsman,170000000,155136755,245884991,401021746
"Jul 1, 2003",2003,Terminator 3: Rise of the Machines,170000000,150358296,282700000,433058296
"May 7, 2004",2004,Van Helsing,170000000,120150546,180000000,300150546
"Mar 29, 2019",2019,Dumbo,170000000,113883318,231121104,345004422
"May 22, 2015",2015,Tomorrowland,170000000,93436322,113191196,206627518
"Feb 14, 2019",2019,Alita: Battle Angel,170000000,85710210,317265826,402976036
"May 31, 2019",2019,Godzilla: King of the Monsters,170000000,85576941,213700000,299276941
"May 27, 2016",2016,Alice Through the Looking Glass,170000000,77042381,199885731,276928112
"May 21, 2010",2010,Shrek Forever After,165000000,238736787,517507886,756244673
"Nov 4, 2016",2016,Doctor Strange,165000000,232641920,443762646,676404566
"Nov 7, 2014",2014,Big Hero 6,165000000,222527828,429600000,652127828
"Mar 26, 2010",2010,How to Train Your Dragon,165000000,217581232,277289760,494870992
"Nov 2, 2012",2012,Wreck-It Ralph,165000000,189412677,307098844,496511521
"Nov 5, 2014",2014,Interstellar,165000000,188017894,478361481,666379375
"Jun 24, 2016",2016,Independence Day: Resurgence,165000000,103144286,281025138,384169424
"Jul 29, 2011",2011,Cowboys and Aliens,163000000,100368560,75669764,176038324
"Mar 17, 2017",2017,Beauty and the Beast,160000000,504014165,755185541,1259199706
"Dec 21, 2018",2018,Aquaman,160000000,335061807,811832833,1146894640
"May 17, 2007",2007,Shrek the Third,160000000,322719944,484610992,807330936
"Jul 16, 2010",2010,Inception,160000000,292576195,542948447,835524642
"Nov 20, 2015",2015,The Hunger Games: Mockingjay - Part 2,160000000,281723902,367262885,648986787
"May 24, 2013",2013,Fast and Furious 6,160000000,238679850,550620594,789300444
"May 16, 2014",2014,Godzilla,160000000,200676069,328400000,529076069
"Jun 3, 2011",2011,X-Men: First Class,160000000,146408305,209000000,355408305
"Dec 25, 2008",2008,The Curious Case of Benjamin Button,160000000,127509326,202122632,329631958
"Jul 14, 2010",2010,The Sorcerer's Apprentice,160000000,63150991,154835329,217986320
"May 12, 2006",2006,Poseidon,160000000,60674817,121000000,181674817
"Jun 10, 2016",2016,Warcraft,160000000,47225655,378296626,425522281
"Sep 30, 2016",2016,Deepwater Horizon,156000000,61433527,61170297,122603824
"Dec 10, 2010",2010,The Chronicles of Narnia: The Voyage of the Dawn Treader,155000000,104386950,313800000,418186950
"Jul 1, 2015",2015,Terminator: Genisys,155000000,89760956,342389938,432150894
"Mar 23, 2018",2018,Pacific Rim: Uprising,155000000,59874525,231055623,290930148
"Nov 24, 2004",2004,Alexander,155000000,34297191,133000000,167297191
"Jul 14, 2017",2017,War for the Planet of the Apes,152000000,146880162,342712105,489592267
"May 25, 2001",2001,Pearl Harbor,151500000,198539855,250700000,449239855
"Jul 2, 2007",2007,Transformers,151000000,319246193,389026399,708272592
"Jun 2, 2017",2017,Wonder Woman,150000000,412563408,408569970,821133378
"Nov 22, 2013",2013,Frozen,150000000,400738009,871731901,1272469910
"Mar 4, 2016",2016,Zootopia,150000000,341268248,678161368,1019429616
"Jul 11, 2007",2007,Harry Potter and the Order of the Phoenix,150000000,292137260,650939197,943076457
"Nov 18, 2005",2005,Harry Potter and the Goblet of Fire,150000000,290201752,606898042,897099794
"May 15, 2003",2003,The Matrix Reloaded,150000000,281553689,457023240,738576929
"Dec 14, 2007",2007,I am Legend,150000000,256393010,329139674,585532684
"Nov 23, 2016",2016,Moana,150000000,248757044,388760321,637517365
"Jul 1, 2008",2008,Hancock,150000000,227946274,396287998,624234272
"Jul 15, 2005",2005,Charlie and the Chocolate Factory,150000000,206459076,269366408,475825484
"Jun 29, 2007",2007,Ratatouille,150000000,206445654,420104041,626549695
"Nov 8, 2013",2013,Thor: The Dark World,150000000,206362140,438240376,644602516
"Jun 15, 2005",2005,Batman Begins,150000000,205343774,153798948,359142722
"Jul 31, 2015",2015,Mission: ImpossibleâRogue Nation,150000000,195042377,493816615,688858992
"Jul 21, 2017",2017,Dunkirk,150000000,190068280,309769088,499837368
"May 6, 2011",2011,Thor,150000000,181030624,268295994,449326618
"Nov 7, 2008",2008,Madagascar: Escape 2 Africa,150000000,180174880,419505894,599680774
"May 1, 2009",2009,X-Men Origins: Wolverine,150000000,179883157,194942603,374825760
"May 22, 2009",2009,Night at the Museum: Battle of the Smithsonian,150000000,177243721,224987342,402231063
"May 26, 2011",2011,Kung Fu Panda 2,150000000,165249063,499588484,664837547
"May 15, 2015",2015,Mad Max: Fury Road,150000000,153636354,216461666,370098020
"May 10, 2019",2019,PokÃ©mon: Detective Pikachu,150000000,139507806,271750627,411258433
"Nov 5, 2003",2003,The Matrix Revolutions,150000000,139270910,288029350,427300260
"Mar 29, 2018",2018,Ready Player One,150000000,137690172,441599964,579290136
"Nov 4, 2005",2005,Chicken Little,150000000,135386665,174657158,310043823
"May 5, 2006",2006,Mission: Impossible III,150000000,133501348,264000000,397501348
"May 15, 2009",2009,Angels & Demons,150000000,133375846,357500000,490875846
"May 14, 2004",2004,Troy,150000000,133298577,350862688,484161265
"Jul 1, 2010",2010,The Last Airbender,150000000,131772187,187941694,319713881
"Nov 2, 2007",2007,Bee Movie,150000000,126631277,160963300,287594577
"Jul 24, 2009",2009,G-Force,150000000,119436770,173381071,292817841
"Nov 21, 2008",2008,Bolt,150000000,114053579,213961450,328015029
"Mar 30, 2012",2012,Wrath of the Titans,150000000,83670083,221600000,305270083
"Nov 16, 2007",2007,Beowulf,150000000,82280579,112800000,195080579
"May 11, 2012",2012,Dark Shadows,150000000,79727149,158475519,238202668
"Jun 28, 2013",2013,White House Down,150000000,73103784,132336603,205440387
"Feb 12, 2010",2010,The Wolfman,150000000,62189884,80444474,142634358
"Feb 17, 2017",2017,The Great Wall,150000000,45157105,289329747,334486852
"Oct 9, 2015",2015,Pan,150000000,35088320,116437653,151525973
"Mar 11, 2011",2011,Mars Needs Moms,150000000,21392758,18157000,39549758
"Dec 31, 2020",2020,Moonfall,150000000,0,0,0
"Nov 3, 2006",2006,Flushed Away,149000000,64665672,114691454,179357126
"Jun 8, 2012",2012,Madagascar 3: Europe's Most Wanted,145000000,216391482,530529789,746921271
"Dec 16, 2011",2011,Mission: ImpossibleâGhost Protocol,145000000,209397903,485315327,694713230
"Jun 13, 2014",2014,How to Train Your Dragon 2,145000000,177002924,437583346,614586270
"Jun 16, 1999",1999,Tarzan,145000000,171091819,277100000,448191819
"Mar 7, 2014",2014,Mr. Peabody & Sherman,145000000,111506430,158300000,269806430
"Nov 21, 2012",2012,Rise of the Guardians,145000000,103412758,203488144,306900902
"Apr 8, 2005",2005,Sahara,145000000,68671925,53000000,121671925
"Jul 15, 2016",2016,Ghostbusters,144000000,128350574,100658084,229008658
"Nov 22, 2002",2002,Die Another Day,142000000,160942139,271000000,431942139
"Jul 9, 2003",2003,Pirates of the Caribbean: The Curse of the Black Pearl,140000000,305411224,329542879,634954103
"May 8, 2009",2009,Star Trek,140000000,257730019,129109595,386839614
"Jul 1, 1998",1998,Armageddon,140000000,201578182,353021818,554600000
"Jul 3, 2002",2002,Men in Black 2,140000000,190418803,251349000,441767803
"Jul 22, 2011",2011,Captain America: The First Avenger,140000000,176654505,193915271,370569776
"Jan 29, 2016",2016,Kung Fu Panda 3,140000000,143528619,374070523,517599142
"Jul 10, 1998",1998,Lethal Weapon 4,140000000,130444603,154955397,285400000
"Mar 27, 2013",2013,G.I. Joe: Retaliation,140000000,122523060,253217645,375740705
"Dec 5, 2003",2003,The Last Samurai,140000000,111110575,345700000,456810575
"Dec 21, 2005",2005,Fun With Dick And Jane,140000000,110550000,92468919,203018919
"Dec 12, 2014",2014,Exodus: Gods and Kings,140000000,65014513,203300000,268314513
"Jul 1, 2016",2016,The BFG,140000000,55483770,144162910,199646680
"Feb 26, 2016",2016,Gods of Egypt,140000000,31153464,107683292,138836756
"May 3, 2002",2002,Spider-Man,139000000,403706375,418000000,821706375
"Mar 6, 2009",2009,Watchmen,138000000,107509799,79466451,186976250
"Jul 29, 2005",2005,Stealth,138000000,32116746,44300000,76416746
"Jun 13, 2008",2008,The Incredible Hulk,137500000,134806913,130766946,265573859
"Jun 20, 2003",2003,Hulk,137000000,132177234,112898200,245075434
"Jul 11, 2001",2001,Final Fantasy: The Spirits Within,137000000,32131830,53000000,85131830
"Nov 16, 2012",2012,"The Twilight Saga: Breaking Dawn, Part 2",136200000,292324737,537400000,829724737
"Mar 22, 2013",2013,The Croods,135000000,187168425,385900000,573068425
"Dec 25, 2015",2015,The Revenant,135000000,183637894,349300408,532938302
"Nov 19, 1999",1999,The World is Not Enough,135000000,126930660,234800000,361730660
"Mar 4, 2011",2011,Rango,135000000,123477607,122246993,245724600
"Nov 14, 2003",2003,Master and Commander: The Far Side of the World,135000000,93926386,118985751,212912137
"Jul 17, 2013",2013,Turbo,135000000,83028130,203868448,286896578
"Jun 3, 2016",2016,Teenage Mutant Ninja Turtles: Out of the Shadows,135000000,82051601,163276773,245328374
"Nov 18, 2011",2011,Happy Feet Two,135000000,64006466,93950000,157956466
"Jul 28, 2006",2006,Miami Vice,135000000,63478838,100339718,163818556
"Nov 2, 2018",2018,The Nutcracker and the Four Realms,132900000,54858851,115435048,170293899
"Jun 29, 2005",2005,War of the Worlds,132000000,234280354,372556181,606836535
"Nov 26, 2014",2014,Penguins of Madagascar,132000000,83350911,283591620,366942531
"Nov 22, 2013",2013,The Hunger Games: Catching Fire,130000000,424668047,440200000,864868047
"Jun 4, 2004",2004,Harry Potter and the Prisoner of Azkaban,130000000,249757726,547149597,796907323
"Aug 3, 2007",2007,The Bourne Ultimatum,130000000,227471070,216572326,444043396
"Jul 6, 2018",2018,Ant-Man and the Wasp,130000000,216648740,406495920,623144660
"Jun 6, 2008",2008,Kung Fu Panda,130000000,215434591,416475940,631910531
"Jul 17, 2015",2015,Ant-Man,130000000,180202163,338656286,518858449
"Mar 27, 2015",2015,Home,130000000,177397510,208600386,385997896
"Dec 19, 2018",2018,Mary Poppins Returns,130000000,171958438,169570080,341528518
"Oct 28, 2011",2011,Puss in Boots,130000000,149260504,405726973,554987477
"Nov 5, 2010",2010,Megamind,130000000,148415853,173471355,321887208
"Jul 18, 2003",2003,Bad Boys II,130000000,138540870,134731112,273271982
"Apr 11, 2014",2014,Rio 2,130000000,131538435,361307856,492846291
"Jul 23, 2010",2010,Salt,130000000,118311368,172339126,290650494
"Mar 28, 2014",2014,Noah,130000000,101200044,251631021,352831065
"Dec 21, 2011",2011,The Adventures of Tintin,130000000,77591831,296402120,373993951
"May 31, 2013",2013,After Earth,130000000,60522097,190977568,251499665
"Nov 26, 2008",2008,Australia,130000000,49554002,165526808,215080810
"Jul 19, 2013",2013,R.I.P.D.,130000000,33618855,45457823,79076678
"Feb 22, 2019",2019,How to Train Your Dragon: The Hidden World,129000000,160791800,358466483,519258283
"Nov 18, 2011",2011,"The Twilight Saga: Breaking Dawn, Part 1",127500000,281287133,408132918,689420051
"May 19, 2000",2000,Dinosaur,127500000,137748063,218400000,356148063
"Mar 3, 2017",2017,Logan,127000000,226277068,389184326,615461394
"Dec 19, 2014",2014,Night at the Museum: Secret of the Tomb,127000000,113746621,240010000,353756621
"Jul 15, 2011",2011,Harry Potter and the Deathly Hallows: Part II,125000000,381193157,960500000,1341693157
"Nov 21, 2014",2014,The Hunger Games: Mockingjay - Part 1,125000000,337135885,429439246,766575131
"Nov 16, 2001",2001,Harry Potter and the Sorcererâs Stone,125000000,317871467,657176139,975047606
"Nov 19, 2010",2010,Harry Potter and the Deathly Hallows: Part I,125000000,296131568,664300000,960431568
"May 19, 2006",2006,The Da Vinci Code,125000000,217536138,550284321,767820459
"May 2, 2003",2003,X-Men 2,125000000,214949694,191925842,406875536
"Apr 29, 2011",2011,Fast Five,125000000,210031325,420132129,630163454
"Aug 8, 2014",2014,Teenage Mutant Ninja Turtles,125000000,191204754,293800000,485004754
"Dec 16, 2011",2011,Sherlock Holmes: A Game of Shadows,125000000,186848418,348815025,535663443
"May 28, 2004",2004,The Day After Tomorrow,125000000,186740799,369578651,556319450
"Mar 31, 2017",2017,The Boss Baby,125000000,175003033,335875729,510878762
"Apr 1, 2010",2010,Clash of the Titans,125000000,163214888,330000000,493214888
"Nov 4, 2016",2016,Trolls,125000000,153707064,190443070,344150134
"May 19, 1998",1998,Godzilla,125000000,136314294,239685706,376000000
"Jun 8, 2012",2012,Prometheus,125000000,126477084,275971181,402448265
"Aug 10, 2012",2012,The Bourne Legacy,125000000,113203870,167152050,280355920
"Jun 20, 1997",1997,Batman & Robin,125000000,107325195,130992619,238317814
"Jul 13, 2018",2018,Skyscraper,125000000,68420120,235695414,304115534
"Aug 3, 2012",2012,Total Recall,125000000,58877969,152978119,211856088
"Dec 21, 2016",2016,Assassinâs Creed,125000000,54647948,186111734,240759682
"Jan 13, 2017",2017,Monster Trucks,125000000,33370166,28272632,61642798
"Aug 27, 1999",1999,The 13th Warrior,125000000,32698899,29000000,61698899
"Nov 17, 2000",2000,How the Grinch Stole Christmas,123000000,260044825,85096578,345141403
"May 24, 2000",2000,Mission: Impossible 2,120000000,215409889,334178627,549588516
"Jun 30, 2000",2000,The Perfect Storm,120000000,182618434,146093000,328711434
"Jul 29, 2016",2016,Jason Bourne,120000000,162192920,253975396,416168316
"Jun 15, 2007",2007,Fantastic Four: Rise of the Silver Surfer,120000000,131921738,157558953,289480691
"Nov 21, 2012",2012,Life of Pi,120000000,124987022,495924981,620912003
"Feb 16, 2007",2007,Ghost Rider,120000000,115802596,113742993,229545589
"Apr 13, 2018",2018,Rampage,120000000,101028233,327028047,428056280
"Jun 27, 2003",2003,Charlie's Angels: Full Throttle,120000000,100814328,126385672,227200000
"Aug 9, 2013",2013,Elysium,120000000,93050117,193141974,286192091
"Apr 19, 2013",2013,Oblivion,120000000,89107235,198809398,287916633
"Mar 24, 2017",2017,Power Rangers,120000000,85364450,57167102,142531552
"Jul 19, 2002",2002,Stuart Little 2,120000000,64956806,101043194,166000000
"Feb 12, 2014",2014,RoboCop,120000000,58607007,184374792,242981799
"Jun 11, 2004",2004,The Chronicles of Riddick,120000000,57712751,49500000,107212751
"Aug 7, 2015",2015,Fantastic Four,120000000,56117548,111731639,167849187
"May 9, 2008",2008,Speed Racer,120000000,43945766,49448696,93394462
"Jul 22, 2005",2005,The Island,120000000,35818913,127200000,163018913
"Dec 17, 2010",2010,How Do You Know?,120000000,30212620,19415557,49628177
"Jun 23, 2010",2010,Knight and Day,117000000,76423035,182328335,258751370
"Oct 5, 2018",2018,Venom,116000000,213511408,640117197,853628605
"May 19, 1999",1999,Star Wars Ep. I: The Phantom Menace,115000000,474544677,552500000,1027044677
"May 19, 2005",2005,Star Wars Ep. III: Revenge of the Sith,115000000,380270577,468728300,848998877
"May 16, 2002",2002,Star Wars Ep. II: Attack of the Clones,115000000,310676740,346018875,656695615
"Nov 2, 2001",2001,"Monsters, Inc.",115000000,289423425,270334294,559757719
"Jul 26, 2013",2013,The Wolverine,115000000,132556852,283900000,416456852
"Feb 7, 1997",1997,Dante's Peak,115000000,67163857,111036143,178200000
"Apr 22, 2016",2016,The Huntsman: Winterâs War,115000000,48003015,117146287,165149302
"Jun 14, 2002",2002,Windtalkers,115000000,40914068,36714197,77628265
"Jul 4, 2008",2008,AstÃ©rix aux Jeux Olympiques,113500000,999811,132000000,132999811
"Dec 25, 2010",2010,Gulliver's Travels,112000000,42779261,189238587,232017848
"Dec 15, 2017",2017,Ferdinand,111000000,84410380,205437550,289847930
"May 18, 2018",2018,Deadpool 2,110000000,324591735,462088822,786680557
"Oct 4, 2013",2013,Gravity,110000000,274092705,419605968,693698673
"Dec 22, 2006",2006,Night at the Museum,110000000,250863268,328583139,579446407
"Jun 10, 2005",2005,Mr. and Mrs. Smith,110000000,186336279,299787811,486124090
"May 29, 2015",2015,San Andreas,110000000,155190832,301067707,456258539
"Jul 29, 2011",2011,The Smurfs,110000000,142614158,421135165,563749323
"Jun 27, 2007",2007,Live Free or Die Hard,110000000,134529403,247758744,382288147
"Mar 20, 2015",2015,The Divergent Series: Insurgent,110000000,130179072,164896810,295075882
"Dec 10, 2004",2004,Ocean's Twelve,110000000,125531634,237457442,362989076
"Dec 19, 1997",1997,Tomorrow Never Dies,110000000,125304276,214200000,339504276
"Jun 28, 2000",2000,The Patriot,110000000,113330342,101969658,215300000
"Mar 7, 2014",2014,300: Rise of an Empire,110000000,106580051,224200000,330780051
"Dec 17, 2004",2004,The Aviator,110000000,102608827,105762065,208370892
"Dec 21, 2016",2016,Passengers,110000000,100014699,202224973,302239672
"Jan 14, 2011",2011,The Green Hornet,110000000,98780042,130375461,229155503
"Sep 30, 2016",2016,Miss Peregrineâs Home for Peculiar Children,110000000,87242834,208744042,295986876
"Oct 7, 2011",2011,Real Steel,110000000,85463309,178417032,263880341
"Jun 11, 2010",2010,The A-Team,110000000,77222099,100019072,177241171
"Jul 31, 2013",2013,The Smurfs 2,110000000,71017784,277529739,348547523
"Mar 18, 2016",2016,The Divergent Series: Allegiant,110000000,66184051,105838466,172022517
"Jun 12, 2009",2009,The Taking of Pelham 123,110000000,65452312,86912058,152364370
"Nov 1, 2013",2013,Ender's Game,110000000,61737191,66246092,127983283
"Apr 2, 2004",2004,Home on the Range,110000000,50026353,26456108,76482461
"Jun 13, 1997",1997,Speed 2: Cruise Control,110000000,48097081,102370919,150468000
"May 6, 2005",2005,Kingdom of Heaven,110000000,47398413,171454940,218853353
"Mar 31, 2017",2017,Ghost in the Shell,110000000,40563557,127347133,167910690
"Jun 16, 2004",2004,Around the World in 80 Days,110000000,24004159,48000000,72004159
"Jun 14, 2019",2019,Men in Black: International,110000000,3100000,0,3100000
"Dec 19, 2001",2001,The Lord of the Rings: The Fellowship of the Ring,109000000,315544750,571666235,887210985
"Nov 21, 2003",2003,The Cat in the Hat,109000000,101018283,32800000,133818283
"Dec 25, 2001",2001,Ali,109000000,58183966,29500000,87683966
"Oct 2, 2015",2015,The Martian,108000000,228433663,426837780,655271443
"Nov 23, 2016",2016,Allied,106000000,40098064,79168597,119266661
"Jul 16, 2004",2004,"I, Robot",105000000,144801023,203828562,348629585
"Dec 17, 1999",1999,Stuart Little,105000000,140015224,158800000,298815224
"Nov 25, 2009",2009,The Princess and the Frog,105000000,104400899,166596479,270997378
"Mar 7, 2008",2008,"10,000 B.C.",105000000,94784201,174281477,269065678
"Jul 22, 2016",2016,Ice Age: Collision Course,105000000,64063008,338093674,402156682
"Apr 27, 2001",2001,Town & Country,105000000,6712451,3652318,10364769
"Sep 22, 2017",2017,Kingsman: The Golden Circle,104000000,100234838,308568858,408803696
"Jun 9, 2000",2000,Gone in 60 Seconds,103300000,101643008,131000000,232643008
"May 5, 2000",2000,Gladiator,103000000,187683805,270000000,457683805
"May 23, 2013",2013,The Hangover 3,103000000,112200072,249800000,362000072
"Mar 9, 2018",2018,A Wrinkle in Time,103000000,100478608,32923274,133401882
"Jul 1, 2009",2009,Public Enemies,102500000,97104620,115178089,212282709
"Nov 17, 2006",2006,Casino Royale,102000000,167365000,427055283,594420283
"Jun 21, 2002",2002,Minority Report,102000000,132024714,226800000,358824714
"Dec 21, 2018",2018,Bumblebee,102000000,127195589,338000000,465195589
"Oct 26, 2012",2012,Cloud Atlas,102000000,27108272,103564882,130673154
"Nov 15, 2002",2002,Harry Potter and the Chamber of Secrets,100000000,262233381,616991754,879225135
"Jul 2, 1991",1991,Terminator 2: Judgment Day,100000000,203464105,311955722,515419827
"Jun 16, 1995",1995,Batman Forever,100000000,184031112,152498032,336529144
"Jul 27, 2001",2001,Planet of the Apes,100000000,180011740,182200000,362211740
"Nov 19, 2004",2004,National Treasure,100000000,173005002,158318408,331323410
"Dec 25, 2012",2012,Django Unchained,100000000,162805434,287142889,449948323
"Dec 22, 2010",2010,Little Fockers,100000000,148438600,162211974,310650574
"Jul 15, 1994",1994,True Lies,100000000,146282411,219017589,365300000
"Nov 2, 2007",2007,American Gangster,100000000,130164645,137820811,267985456
"Sep 18, 2009",2009,Cloudy with a Chance of Meatballs,100000000,124870275,111957402,236827677
"Aug 6, 2010",2010,The Other Guys,100000000,119219978,51716492,170936470
"Dec 17, 2004",2004,Lemony Snicket's A Series of Unfortunate Events,100000000,118627117,94328907,212956024
"Dec 25, 2013",2013,The Wolf of Wall Street,100000000,116900694,272969720,389870414
"May 24, 2013",2013,Epic,100000000,107518682,155275759,262794441
"Jun 21, 1996",1996,Eraser,100000000,101295562,133104438,234400000
"Jun 21, 1996",1996,The Hunchback of Notre Dame,100000000,100138851,225361149,325500000
"Dec 15, 2000",2000,The Emperor's New Groove,100000000,89296573,80000000,169296573
"Aug 17, 2012",2012,The Expendables 2,100000000,85028192,226951064,311979256
"Oct 16, 2009",2009,Where the Wild Things Are,100000000,77233467,21890189,99123656
"Dec 15, 2006",2006,Eragon,100000000,75030163,174457952,249488115
"Jul 25, 2014",2014,Hercules,100000000,72688614,170700000,243388614
"Dec 10, 2010",2010,The Tourist,100000000,67631157,211100212,278731369
"Nov 24, 1999",1999,End of Days,100000000,66889043,145137932,212026975
"Jun 11, 2004",2004,The Stepford Wives,100000000,59475623,36746348,96221971
"Jun 8, 2007",2007,Surf's Up,100000000,58867694,86528051,145395745
"Dec 8, 2006",2006,Blood Diamond,100000000,57377916,114000000,171377916
"Sep 24, 2010",2010,Legend of the Guardians: The Owls of Ga'Hoole,100000000,55675313,84041404,139716717
"Nov 7, 1997",1997,Starship Troopers,100000000,54768952,66331048,121100000
"Jun 5, 2009",2009,Land of the Lost,100000000,49438370,20110271,69548641
"Dec 25, 2003",2003,Peter Pan,100000000,48417850,46837635,95255485
"Mar 15, 2019",2019,Wonder Park,100000000,45216793,69932629,115149422
"Jul 23, 2004",2004,Catwoman,100000000,40202379,41943000,82145379
"Aug 15, 2014",2014,The Expendables 3,100000000,39322544,170138834,209461378
"Nov 27, 2002",2002,Treasure Planet,100000000,38120554,53679446,91800000
"Mar 12, 2010",2010,Green Zone,100000000,35497337,62025683,97523020
"Oct 20, 2017",2017,Geostorm,100000000,33700160,187095849,220796009
"Dec 25, 2015",2015,Point Break,100000000,28782481,97922110,126704591
"Dec 11, 2015",2015,In the Heart of the Sea,100000000,25020758,64672551,89693309
"Apr 18, 2014",2014,Transcendence,100000000,23022309,80016949,103039258
"Feb 18, 2005",2005,Son of the Mask,100000000,17018422,42900000,59918422
"Dec 14, 2018",2018,Mortal Engines,100000000,15951040,69336377,85287417
"Aug 16, 2002",2002,The Adventures of Pluto Nash,100000000,4411102,2683893,7094995
"Jan 20, 2012",2012,Jin lÃ­ng shÃ­ san chai,100000000,311434,97915583,98227017
"Nov 6, 2015",2015,The Peanuts Movie,99000000,130178411,119913199,250091610
"Feb 8, 2019",2019,The LEGO Movie 2: The Second Part,99000000,105806508,84519190,190325698
"Nov 21, 2018",2018,Robin Hood,99000000,30824628,53922813,84747441
"May 4, 2001",2001,The Mummy Returns,98000000,202007640,233032755,435040395
"Dec 20, 2002",2002,Gangs of New York,97000000,77730500,105394121,183124621
"May 19, 2017",2017,Alien: Covenant,97000000,74262031,164259216,238521247
"Mar 13, 2015",2015,Cinderella,95000000,201151353,333400000,534551353
"Jul 13, 2012",2012,Ice Age: Continental Drift,95000000,161321843,718443294,879765137
"Dec 28, 2001",2001,Black Hawk Down,95000000,108638745,51052340,159691085
"May 27, 2010",2010,Sex and the City 2,95000000,95347692,199333086,294680778
"Feb 12, 2010",2010,Percy Jackson & the Olympians: The Lightning Thief,95000000,88768303,134282571,223050874
"Aug 10, 2012",2012,The Campaign,95000000,86907746,18000000,104907746
"Nov 12, 2010",2010,Unstoppable,95000000,81562942,84157979,165720921
"May 9, 1997",1997,The Fifth Element,95000000,63570862,200327899,263898761
"Mar 31, 2000",2000,The Road to El Dorado,95000000,50802661,14897339,65700000
"Dec 11, 2009",2009,The Lovely Bones,95000000,44114232,50780216,94894448
"Aug 19, 2016",2016,Ben-Hur,95000000,26410477,65259171,91669648
"Feb 6, 2015",2015,Seventh Son,95000000,17725785,91149182,108874967
"May 30, 2003",2003,Finding Nemo,94000000,380529370,555900000,936429370
"Dec 17, 2003",2003,The Lord of the Rings: The Return of the King,94000000,377845905,763557436,1141403341
"Dec 18, 2002",2002,The Lord of the Rings: The Two Towers,94000000,342548984,592150661,934699645
"Jun 15, 2001",2001,Lara Croft: Tomb Raider,94000000,131144183,142186002,273330185
"Feb 13, 2015",2015,Kingsman: The Secret Service,94000000,128261724,276300000,404561724
"Jul 18, 2001",2001,Jurassic Park III,93000000,181166115,184733885,365900000
"Aug 5, 2011",2011,Rise of the Planet of the Apes,93000000,176760185,294226015,470986200
"Feb 14, 2008",2008,The Spiderwick Chronicles,92500000,71195053,91644614,162839667
"Nov 5, 2004",2004,The Incredibles,92000000,261441092,353285660,614726752
"Feb 14, 2013",2013,A Good Day to Die Hard,92000000,67349198,236900000,304249198
"Apr 9, 2004",2004,The Alamo,92000000,22406362,1505000,23911362
"Dec 22, 1995",1995,Cutthroat Island,92000000,10017322,8500000,18517322
"Dec 25, 2013",2013,The Secret Life of Walter Mitty,91000000,58236838,129624345,187861183
"Dec 20, 2017",2017,Jumanji: Welcome to the Jungle,90000000,404508916,559987277,964496193
"Jul 1, 1997",1997,Men in Black,90000000,250690539,337100000,587790539
"Nov 19, 1999",1999,Toy Story 2,90000000,245852179,265506097,511358276
"Aug 3, 2001",2001,Rush Hour 2,90000000,226164286,121261546,347425832
"Dec 25, 2009",2009,Sherlock Holmes,90000000,209028679,289409533,498438212
"Jul 1, 2009",2009,Ice Age: Dawn of the Dinosaurs,90000000,196573705,663128152,859701857
"Dec 14, 2018",2018,Spider-Man: Into The Spider-Verse 3D,90000000,190173195,185208573,375381768
"Jul 21, 2000",2000,What Lies Beneath,90000000,155464351,133229638,288693989
"Apr 15, 2011",2011,Rio,90000000,143619809,343900000,487519809
"Oct 6, 2006",2006,The Departed,90000000,132384315,157276304,289660619
"Nov 3, 2000",2000,Charlie's Angels,90000000,125305545,134430545,259736090
"Jun 19, 1998",1998,Mulan,90000000,120620254,182879746,303500000
"Aug 13, 2008",2008,Tropic Thunder,90000000,110515313,80629943,191145256
"Dec 20, 2011",2011,The Girl with the Dragon Tattoo,90000000,102515793,136858177,239373970
"Jul 11, 1997",1997,Contact,90000000,100920329,64979671,165900000
"Jun 6, 2008",2008,You Don't Mess With the Zohan,90000000,100018837,102892154,202910991
"May 19, 1995",1995,Die Hard: With a Vengeance,90000000,100012499,266089167,366101666
"Sep 23, 2016",2016,The Magnificent Seven,90000000,93432655,69092501,162525156
"Dec 18, 2015",2015,Alvin and the Chipmunks: The Road Chip,90000000,85886987,163630969,249517956
"Jun 8, 2001",2001,Atlantis: The Lost Empire,90000000,84052762,101996258,186049020
"Dec 25, 2008",2008,Valkyrie,90000000,83107829,120824345,203932174
"Jul 24, 2015",2015,Pixels,90000000,78765986,165275818,244041804
"Jun 29, 2001",2001,Artificial Intelligence: AI,90000000,78616689,157283311,235900000
"Nov 26, 2003",2003,The Haunted Mansion,90000000,75817994,79932634,155750628
"Aug 4, 2000",2000,Hollow Man,90000000,73209340,117990660,191200000
"Apr 22, 2005",2005,The Interpreter,90000000,72708161,90045676,162753837
"Aug 7, 2013",2013,Percy Jackson: Sea of Monsters,90000000,68559554,132300000,200859554
"Jul 25, 2003",2003,Lara Croft: Tomb Raider: The Cradle of Life,90000000,65653758,91439185,157092943
"Jun 10, 2016",2016,Now You See Me 2,90000000,65075540,263249467,328325007
"Nov 21, 2001",2001,Spy Game,90000000,62362560,80687000,143049560
"Apr 4, 1997",1997,The Saint,90000000,61363304,108036696,169400000
"Mar 10, 2000",2000,Mission to Mars,90000000,60874615,45125385,106000000
"Mar 16, 2018",2018,Tomb Raider,90000000,58250803,215226698,273477501
"Dec 17, 1999",1999,Bicentennial Man,90000000,58220776,29200000,87420776
"Jul 7, 2004",2004,King Arthur,90000000,51877963,152000000,203877963
"Apr 25, 1997",1997,Volcano,90000000,47546796,72553204,120100000
"Mar 26, 1997",1997,The Devil's Own,90000000,42885593,98014407,140900000
"Jul 19, 2002",2002,K-19: The Widowmaker,90000000,35168966,30547160,65716126
"Aug 19, 2011",2011,Conan the Barbarian,90000000,21295021,42061112,63356133
"Oct 21, 2011",2011,The Three Musketeers,90000000,20377913,119500000,139877913
"Apr 21, 2017",2017,The Promise,90000000,8224288,2327129,10551417
"Nov 24, 2010",2010,The Nutcracker in 3D,90000000,195459,20270557,20466016
"Dec 13, 2017",2017,Bright,90000000,0,0,0
"Dec 31, 2019",2019,Army of the Dead,90000000,0,0,0
"May 10, 1996",1996,Twister,88000000,241688385,254011615,495700000
"Jun 3, 2005",2005,Cinderella Man,88000000,61649911,43371577,105021488
"Sep 14, 2018",2018,The Predator,88000000,51024708,108462855,159487563
"Jul 8, 2005",2005,Fantastic Four,87500000,154696080,178436670,333132750
"Feb 9, 2001",2001,Hannibal,87000000,165092266,185008014,350100280
"Jul 25, 2003",2003,Seabiscuit,86000000,120277854,28437488,148715342
"Dec 22, 2000",2000,Cast Away,85000000,233632142,193598374,427230516
"Nov 17, 2006",2006,Happy Feet,85000000,198000317,187000000,385000317
"Dec 7, 2001",2001,Ocean's Eleven,85000000,183417150,267311379,450728529
"Jul 23, 2004",2004,The Bourne Supremacy,85000000,176087450,134913674,311001124
"Jul 25, 1997",1997,Air Force One,85000000,172956409,142311944,315268353
"Apr 3, 2009",2009,Fast & Furious,85000000,155064265,208000000,363064265
"Mar 14, 2008",2008,Horton Hears a Who,85000000,154529439,144948447,299477886
"Mar 21, 2014",2014,Divergent,85000000,150947895,125067070,276014965
"Sep 28, 2012",2012,Hotel Transylvania,85000000,148313048,230192764,378505812
"Apr 5, 2019",2019,Shazam!,85000000,139606856,223292877,362899733
"Nov 21, 2007",2007,Enchanted,85000000,127706877,212677264,340384141
"Feb 10, 2012",2012,Safe House,85000000,126181630,82360532,208542162
"Jul 20, 2007",2007,I Now Pronounce You Chuck and Larry,85000000,119725280,65983182,185708462
"Jun 8, 2007",2007,Ocean's Thirteen,85000000,117144465,194600000,311744465
"Dec 25, 2009",2009,Itâs Complicated,85000000,112735375,111879369,224614744
"Nov 20, 1998",1998,Enemy of the State,85000000,111549836,139100000,250649836
"Sep 29, 2006",2006,Open Season,85000000,85105259,106826899,191932158
"Nov 4, 2011",2011,Tower Heist,85000000,78046570,72376376,150422946
"Nov 22, 2000",2000,102 Dalmatians,85000000,66941559,0,66941559
"Mar 30, 2012",2012,Mirror Mirror,85000000,64935167,108678315,173613482
"Dec 8, 2006",2006,The Holiday,85000000,63280000,141910324,205190324
"Jun 16, 2006",2006,The Fast and the Furious: Tokyo Drift,85000000,62615510,95178695,157794205
"Dec 9, 2005",2005,Memoirs of a Geisha,85000000,57010853,104500000,161510853
"Mar 16, 2001",2001,Enemy at the Gates,85000000,51396781,45574512,96971293
"Jun 18, 1993",1993,Last Action Hero,85000000,50016394,87282095,137298489
"Sep 26, 2003",2003,The Rundown,85000000,47641743,33190150,80831893
"Nov 23, 2011",2011,Arthur Christmas,85000000,46462469,103254655,149717124
"Jan 20, 2017",2017,xXx: Return of Xander Cage,85000000,44898413,300134946,345033359
"Nov 13, 1998",1998,Meet Joe Black,85000000,44650003,0,44650003
"Jul 30, 2010",2010,Cats & Dogs: The Revenge of Kitty Galore,85000000,43585753,69440630,113026383
"Feb 8, 2002",2002,Collateral Damage,85000000,40048332,38305176,78353508
"Mar 15, 2002",2002,Showtime,85000000,37948765,41000000,78948765
"Jun 30, 1995",1995,Judge Dredd,85000000,34687912,78800000,113487912
"Mar 2, 2007",2007,Zodiac,85000000,33080084,50000000,83080084
"Aug 13, 2010",2010,Scott Pilgrim vs. The World,85000000,31611316,16445448,48056764
"Mar 28, 2003",2003,The Core,85000000,31111260,43021371,74132631
"May 9, 1997",1997,Father's Day,85000000,28681080,7000000,35681080
"Dec 20, 2017",2017,The Greatest Showman,84000000,174340174,212325376,386665550
"Jun 14, 2002",2002,Scooby-Doo,84000000,153294164,123000000,276294164
"Jul 28, 2000",2000,Nutty Professor II: The Klumps,84000000,123307945,43000000,166307945
"Jul 19, 2013",2013,RED 2,84000000,53262560,88244795,141507355
"Jun 23, 2006",2006,Click,82500000,137355633,100329456,237685089
"Dec 15, 2006",2006,Charlotte's Web,82500000,82985708,61000000,143985708
"Feb 14, 2008",2008,Jumper,82500000,80172128,142468684,222640812
"Jul 11, 2008",2008,Hellboy II: The Golden Army,82500000,75986503,84401560,160388063
"May 27, 2005",2005,The Longest Yard,82000000,158119460,33439045,191558505
"Aug 13, 2010",2010,The Expendables,82000000,103068524,165199650,268268174
"Nov 17, 2000",2000,The 6th Day,82000000,34543701,61481197,96024898
"Feb 21, 2020",2020,Call of the Wild,82000000,0,0,0
"May 23, 2003",2003,Bruce Almighty,81000000,242704995,241763613,484468608
"Mar 23, 2012",2012,The Hunger Games,80000000,408010692,269912687,677923379
"May 26, 2011",2011,The Hangover Part II,80000000,254464305,332000000,586464305
"May 21, 1996",1996,Mission: Impossible,80000000,180981886,276716108,457697994
"Feb 10, 2017",2017,The Lego Batman Movie,80000000,175750384,134909634,310660018
"Sep 25, 2015",2015,Hotel Transylvania 2,80000000,169700110,299800188,469500298
"Jun 18, 1992",1992,Batman Returns,80000000,162833635,103990656,266824291
"May 7, 1999",1999,The Mummy,80000000,155385488,261000000,416385488
"May 19, 2006",2006,Over the Hedge,80000000,155019340,188377907,343397247
"Jun 21, 2002",2002,Lilo & Stitch,80000000,145771527,100028473,245800000
"May 8, 1998",1998,Deep Impact,80000000,140464664,209000000,349464664
"Jul 12, 2013",2013,Grown Ups 2,80000000,133668525,113355283,247023808
"Dec 16, 2011",2011,Alvin and the Chipmunks: Chipwrecked,80000000,133107389,215981134,349088523
"Jun 20, 2008",2008,Get Smart,80000000,130319208,96420208,226739416
"Mar 11, 2005",2005,Robots,80000000,128200012,132500000,260700012
"Feb 19, 2010",2010,Shutter Island,80000000,128012934,171448848,299461782
"Dec 12, 2003",2003,Something's Gotta Give,80000000,124685242,142000000,266685242
"Nov 26, 2008",2008,Four Christmases,80000000,120146040,48165518,168311558
"Jun 27, 1997",1997,Face/Off,80000000,112276146,128923854,241200000
"Dec 25, 2008",2008,Bedtime Stories,80000000,110101975,111366960,221468935
"Jul 12, 2002",2002,Road to Perdition,80000000,104054514,79300000,183354514
"Feb 11, 2011",2011,Just Go With It,80000000,103028109,111946844,214974953
"Feb 14, 2003",2003,Daredevil,80000000,102543518,80239000,182782518
"Sep 26, 2008",2008,Eagle Eye,80000000,101440743,79144516,180585259
"Jun 6, 1997",1997,Con Air,80000000,101117573,123000000,224117573
"Dec 17, 2010",2010,Yogi Bear,80000000,100246011,104528679,204774690
"Dec 25, 2003",2003,Cold Mountain,80000000,95632614,69541295,165173909
"Jan 15, 2010",2010,The Book of Eli,80000000,94835059,63915758,158750817
"Nov 26, 1997",1997,Flubber,80000000,92993801,85000000,177993801
"Jul 23, 1999",1999,The Haunting,80000000,91188905,89000000,180188905
"Nov 15, 1996",1996,Space Jam,80000000,90463534,159736466,250200000
"Oct 17, 2014",2014,Fury,80000000,85817906,124497775,210315681
"Sep 28, 2018",2018,Smallfoot,80000000,83240103,130451174,213691277
"Feb 10, 2006",2006,The Pink Panther,80000000,82226474,76700000,158926474
"Jul 8, 2011",2011,Zookeeper,80000000,80360866,90444659,170805525
"Dec 12, 2008",2008,The Day the Earth Stood Still,80000000,79366978,158003372,237370350
"Aug 8, 1997",1997,Conspiracy Theory,80000000,76118990,66664728,142783718
"Jun 12, 1998",1998,"Six Days, Seven Nights",80000000,74339294,90460706,164800000
"May 24, 2002",2002,Spirit: Stallion of the Cimarron,80000000,73215310,33300000,106515310
"Jun 8, 2001",2001,Swordfish,80000000,69772969,77307444,147080413
"Dec 31, 1999",1999,Fantasia 2000 (Theatrical Release),80000000,69610858,7776,69618634
"Apr 3, 1998",1998,Lost In Space,80000000,69117629,66929688,136047317
"Jul 30, 2004",2004,The Manchurian Candidate,80000000,65948711,30200000,96148711
"Nov 22, 2006",2006,DÃ©jÃ Vu,80000000,64038616,117000000,181038616
"Jun 7, 2019",2019,The Secret Life of Pets 2,80000000,63795655,49555841,113351496
"Jun 24, 2005",2005,Bewitched,80000000,63313159,67846147,131159306
"Mar 8, 2002",2002,The Time Machine,80000000,56684819,42298771,98983590
"Oct 2, 1998",1998,What Dreams May Come,80000000,55485043,16000000,71485043
"Dec 25, 1998",1998,Mighty Joe Young,80000000,50632037,0,50632037
"Oct 28, 2005",2005,The Legend of Zorro,80000000,45575336,95900000,141475336
"Nov 10, 2000",2000,Little Nicky,80000000,39442871,18827520,58270391
"Sep 25, 2009",2009,Surrogates,80000000,38577772,81090578,119668350
"Jun 8, 2001",2001,Evolution,80000000,38311134,60030798,98341932
"Aug 26, 2005",2005,The Brothers Grimm,80000000,37899638,67400000,105299638
"Dec 13, 1996",1996,Mars Attacks!,80000000,37771017,63600000,101371017
"Apr 14, 2006",2006,The Wild,80000000,37384046,61626621,99010667
"Dec 20, 2013",2013,Walking with Dinosaurs,80000000,36076121,87292721,123368842
"Dec 22, 2000",2000,Thirteen Days,80000000,34566746,31987801,66554547
"Dec 6, 1996",1996,Daylight,80000000,32908290,126000000,158908290
"Oct 23, 2015",2015,The Last Witch Hunter,80000000,27367660,103451252,130818912
"Feb 21, 2014",2014,Pompeii,80000000,23169033,85300000,108469033
"May 12, 2000",2000,Battlefield Earth: A Saga of the Year 3000,80000000,21471685,8253978,29725663
"Nov 14, 2003",2003,Looney Tunes: Back in Action,80000000,20950820,33589842,54540662
"Dec 18, 2009",2009,Nine,80000000,19676965,33831893,53508858
"Nov 26, 2003",2003,Timeline,80000000,19480739,7222445,26703184
"Apr 22, 2010",2010,Oceans,80000000,19422319,67365211,86787530
"Nov 25, 1998",1998,Babe: Pig in the City,80000000,18319860,50812000,69131860
"Dec 25, 1997",1997,The Postman,80000000,17650704,3190419,20841123
"Nov 10, 2000",2000,Red Planet,80000000,17480890,15983079,33463969
"Jan 12, 2007",2007,Arthur et les Minimoys,80000000,15132763,98192980,113325743
"Aug 17, 2007",2007,The Invasion,80000000,15074191,25072851,40147042
"Sep 2, 2005",2005,A Sound of Thunder,80000000,1900451,4400000,6300451
"Jun 15, 1994",1994,The Lion King,79300000,421785283,564429585,986214868
"Feb 10, 2012",2012,Journey 2: The Mysterious Island,79000000,103860290,214285872,318146162
"Nov 11, 2011",2011,Jack and Jill,79000000,74158157,76361060,150519217
"Dec 21, 2001",2001,A Beautiful Mind,78000000,170708996,146959062,317668058
"Sep 27, 2013",2013,Cloudy with a Chance of Meatballs 2,78000000,119793567,154599082,274392649
"Oct 4, 2002",2002,Red Dragon,78000000,92955420,113500000,206455420
"Mar 5, 2004",2004,Hidalgo,78000000,67286731,40800000,108086731
"Jul 11, 2003",2003,The League of Extraordinary Gentlemen,78000000,66465204,112800000,179265204
"Aug 20, 2004",2004,Exorcist: The Beginning,78000000,41814863,2142678,43957541
"Dec 31, 2012",2012,AstÃ©rix et ObÃ©lix: Au service de Sa MajestÃ©,77600000,0,60680125,60680125
"Feb 12, 2016",2016,The Little Prince,77500000,1311213,100717706,102028919
"Jan 22, 2019",2019,Renegades,77500000,0,1521672,1521672
"Jul 20, 2018",2018,The Equalizer 2,77000000,102084362,88368770,190453132
"Jul 3, 2013",2013,Despicable Me 2,76000000,368065385,607151450,975216835
"Jun 6, 2003",2003,2 Fast 2 Furious,76000000,127120058,109290549,236410607
"Dec 25, 2006",2006,Children of Men,76000000,35552383,34292628,69845011
"Jun 30, 2000",2000,The Adventures of Rocky & Bullwinkle,76000000,26000610,9129000,35129610
"Jul 8, 2016",2016,The Secret Life of Pets,75000000,368384330,518366204,886750534
"Jul 2, 1996",1996,Independence Day,75000000,306169255,511231623,817400878
"Nov 9, 2018",2018,Dr. Seussâ The Grinch,75000000,270620950,240381476,511002426
"Dec 21, 2016",2016,Sing,75000000,270329045,364125744,634454789
"Jun 30, 2017",2017,Despicable Me 3,75000000,264624300,770103450,1034727750
"May 22, 1997",1997,The Lost World: Jurassic Park,75000000,229086679,389552320,618638999
"Mar 31, 2006",2006,Ice Age: The Meltdown,75000000,195330621,456568661,651899282
"May 27, 2005",2005,Madagascar,75000000,193595521,362964045,556559566
"Jun 25, 2010",2010,Grown Ups,75000000,162001186,110222244,272223430
"Oct 1, 2004",2004,Shark Tale,75000000,161412000,210505043,371917043
"Jul 14, 2000",2000,X-Men,75000000,157299717,139572650,296872367
"Jun 27, 2008",2008,Wanted,75000000,134508551,207907909,342416460
"Jun 7, 1996",1996,The Rock,75000000,134069511,202000000,336069511
"Feb 13, 2004",2004,50 First Dates,75000000,120776832,75543497,196320329
"Jul 20, 2007",2007,Hairspray,75000000,118871849,84163723,203035572
"May 31, 2013",2013,Now You See Me,75000000,117723989,225045211,342769200
"Dec 15, 2006",2006,Dreamgirls,75000000,103365956,52342739,155708695
"Aug 3, 2018",2018,Christopher Robin,75000000,99215042,98289716,197504758
"Jul 23, 1999",1999,Inspector Gadget,75000000,97387965,0,97387965
"Nov 11, 2011",2011,Immortals,75000000,83504017,128058418,211562435
"Jun 18, 2004",2004,The Terminal,75000000,77073959,141600000,218673959
"Feb 18, 2005",2005,Constantine,75000000,75976178,145618733,221594911
"Jul 21, 2006",2006,Monster House,75000000,73661010,67606360,141267370
"Dec 8, 2000",2000,Vertical Limit,75000000,68473360,145026640,213500000
"Dec 21, 2007",2007,Charlie Wilson's War,75000000,66661095,52851676,119512771
"Apr 16, 1999",1999,Life,75000000,64062587,9459000,73521587
"Mar 4, 2005",2005,Be Cool,75000000,55849401,39094616,94944017
"Dec 23, 2005",2005,Munich,75000000,47379090,84113682,131492772
"Jun 4, 2010",2010,Killers,75000000,47059963,48512786,95572749
"Aug 14, 2015",2015,The Man From U.N.C.L.E.,75000000,45445109,59504475,104949584
"Mar 7, 2003",2003,Tears of the Sun,75000000,43632458,42000000,85632458
"Jul 21, 2006",2006,Lady in the Water,75000000,42285169,30500000,72785169
"Dec 17, 2004",2004,Spanglish,75000000,42044321,12300000,54344321
"Oct 12, 2001",2001,Bandits,75000000,41523271,30000000,71523271
"Dec 17, 1999",1999,Anna and the King,75000000,39251128,0,39251128
"Jul 7, 1995",1995,First Knight,75000000,37361412,90000000,127361412
"Mar 25, 2011",2011,Sucker Punch,75000000,36392502,53365887,89758389
"Mar 11, 2005",2005,Hostage,75000000,34636443,43000000,77636443
"Oct 28, 2016",2016,Inferno,75000000,34343574,185175793,219519367
"Jun 13, 2003",2003,Hollywood Homicide,75000000,30207785,20201968,50409753
"Jun 16, 2000",2000,Titan A.E.,75000000,22751979,14000000,36751979
"Dec 17, 2004",2004,Flight of the Phoenix,75000000,21009180,13000000,34009180
"Oct 23, 1998",1998,Soldier,75000000,14623082,0,14623082
"Jan 15, 1999",1999,Virus,75000000,14010690,16616000,30626690
"Feb 23, 2001",2001,Monkeybone,75000000,5409517,0,5409517
"Aug 30, 2019",2019,PLAYMOBIL,75000000,0,0,0
"Dec 31, 2019",2019,355,75000000,0,0,0
"Jul 10, 2015",2015,Minions,74000000,336045770,824290403,1160336173
"Feb 6, 2015",2015,The SpongeBob Movie: Sponge Out of Water,74000000,162994032,148019149,311013181
"Nov 22, 2000",2000,Unbreakable,73243106,94999143,153100000,248099143
"Aug 4, 2006",2006,Talladega Nights: The Ballad of Ricky Bobby,73000000,148213377,14657148,162870525
"May 20, 2016",2016,The Angry Birds Movie,73000000,107509366,244818521,352327887
"Aug 7, 1998",1998,Snake Eyes,73000000,55591409,48300000,103891409
"Feb 13, 1998",1998,Sphere,73000000,37068294,13100000,50168294
"Jul 27, 2007",2007,The Simpsons Movie,72500000,183135014,343936008,527071022
"Feb 8, 2008",2008,Fool's Gold,72500000,70231041,39131925,109362966
"Jul 31, 2009",2009,Funny People,72500000,51855045,20025260,71880305
"Sep 28, 2007",2007,The Kingdom,72500000,47467250,39042352,86509602
"Jun 22, 2001",2001,Dr. Dolittle 2,72000000,112950721,63151000,176101721
"May 24, 1995",1995,Braveheart,72000000,75545647,133499597,209045244
"Nov 4, 2005",2005,Jarhead,72000000,62647540,34300000,96947540
"Apr 27, 2001",2001,Driven,72000000,32616869,22000000,54616869
"Dec 21, 2001",2001,The Majestic,72000000,27796042,9510292,37306334
"Jun 25, 2004",2004,Two Brothers,72000000,19176754,43000000,62176754
"Jul 30, 2004",2004,The Village,71682975,114197520,143444114,257641634
"Jun 26, 1998",1998,Doctor Dolittle,71500000,144156605,150000000,294156605
"Aug 2, 2002",2002,Signs,70702619,227969295,180300000,408269295
"May 19, 2004",2004,Shrek 2,70000000,441226247,495781885,937008132
"Jun 9, 2006",2006,Cars,70000000,244082982,217568264,461651246
"Dec 23, 2009",2009,Alvin and the Chipmunks: The Squeakquel,70000000,219614612,223868601,443483213
"Jun 22, 1988",1988,Who Framed Roger Rabbit?,70000000,154112492,197387508,351500000
"Jul 30, 1999",1999,Runaway Bride,70000000,152257509,157880669,310138178
"Aug 9, 2002",2002,xXx,70000000,141930000,125270000,267200000
"Jun 8, 2018",2018,Oceanâs 8,70000000,140218711,156897265,297115976
"Nov 8, 1996",1996,Ransom,70000000,136492681,172207319,308700000
"Aug 21, 2009",2009,Inglourious Basterds,70000000,120774594,196140670,316915264
"Dec 11, 1991",1991,Hook,70000000,119654823,181200000,300854823
"Jul 3, 1990",1990,Die Hard 2,70000000,117323878,122490147,239814025
"Aug 8, 2003",2003,S.W.A.T.,70000000,116877597,90277151,207154748
"Nov 10, 2017",2017,Daddyâs Home 2,70000000,104029443,71777740,175807183
"Nov 19, 1999",1999,Sleepy Hollow,70000000,101068340,106000000,207068340
"Dec 14, 2001",2001,Vanilla Sky,70000000,100614858,102111747,202726605
"Jun 13, 1997",1997,Hercules,70000000,99112101,151587899,250700000
"Mar 22, 2013",2013,Olympus Has Fallen,70000000,98927592,73951336,172878928
"Mar 11, 2011",2011,Battle: Los Angeles,70000000,83552429,129911547,213463976
"Aug 13, 2004",2004,AVP: Alien Vs. Predator,70000000,80281096,92262423,172543519
"Dec 25, 2011",2011,War Horse,70000000,79883359,76932170,156815529
"Mar 1, 2002",2002,We Were Soldiers,70000000,78120196,36538066,114658262
"Feb 7, 2014",2014,The Monuments Men,70000000,78031620,80671128,158702748
"Sep 23, 2016",2016,Storks,70000000,72679278,110674153,183353431
"Dec 11, 1998",1998,Star Trek: Insurrection,70000000,70187658,47612342,117800000
"Dec 10, 2003",2003,Big Fish,70000000,66432867,57521456,123954323
"Jun 17, 1994",1994,Wolf,70000000,65011757,66000000,131011757
"Jan 20, 2012",2012,Underworld: Awakening,70000000,62321039,98058891,160379930
"Sep 22, 2017",2017,The Lego Ninjago Movie,70000000,59281555,63455646,122737201
"Oct 10, 2014",2014,Dracula Untold,70000000,55991880,164249843,220241723
"Sep 29, 2006",2006,The Guardian,70000000,55011732,39961808,94973540
"Aug 9, 1989",1989,The Abyss,70000000,54243125,0,54243125
"Sep 24, 2010",2010,Wall Street 2: Money Never Sleeps,70000000,52474616,84957003,137431619
"Jan 14, 2011",2011,The Dilemma,70000000,48475290,22071575,70546865
"Dec 25, 2005",2005,Rumor Has It,70000000,42996140,45937422,88933562
"Nov 6, 1998",1998,The Siege,70000000,40934175,75691623,116625798
"Aug 10, 2007",2007,Stardust,70000000,38634938,98387307,137022245
"Jun 15, 2012",2012,Rock of Ages,70000000,38518613,22513319,61031932
"Oct 8, 1997",1997,Seven Years in Tibet,70000000,37945884,93500000,131445884
"Sep 17, 2004",2004,Sky Captain and the World of Tomorrow,70000000,37760080,11970774,49730854
"Sep 14, 2007",2007,The Brave One,70000000,36793804,32998900,69792704
"Nov 1, 2002",2002,I Spy,70000000,33561137,26718685,60279822
"Jun 7, 2002",2002,Bad Company,70000000,30157016,39000000,69157016
"Oct 21, 2005",2005,Doom,70000000,28212337,30544841,58757178
"Jan 29, 2016",2016,The Finest Hours,70000000,27569558,21683203,49252761
"Oct 18, 2013",2013,Escape Plan,70000000,25135965,78600000,103735965
"Sep 23, 2011",2011,Killer Elite,70000000,25124986,40284060,65409046
"Jan 16, 1998",1998,Hard Rain,70000000,19870567,0,19870567
"Feb 15, 2002",2002,Hart's War,70000000,19076815,14000000,33076815
"Feb 8, 2002",2002,Rollerball,70000000,18990542,6861966,25852508
"Jan 10, 2014",2014,The Legend of Hercules,70000000,18848538,40104781,58953319
"Apr 27, 2007",2007,Next,70000000,18211013,55380487,73591500
"Sep 20, 2002",2002,Ballistic: Ecks vs. Sever,70000000,14294842,0,14294842
"Aug 10, 2001",2001,Osmosis Jones,70000000,13596911,0,13596911
"May 9, 2014",2014,Legends of Oz: Dorothyâs Return,70000000,8462347,11645586,20107933
"Jan 16, 2015",2015,Blackhat,70000000,8005980,11659024,19665004
"Mar 31, 2006",2006,Basic Instinct 2,70000000,5946136,29471026,35417162
"May 28, 2010",2010,Agora,70000000,619423,38372869,38992292
"Jul 9, 2010",2010,Despicable Me,69000000,251513985,291950588,543464573
"Jul 30, 2010",2010,Dinner for Schmucks,69000000,73026337,13770165,86796502
"Mar 2, 2018",2018,Red Sparrow,69000000,46874505,99077356,145951861
"Jun 30, 2010",2010,The Twilight Saga: Eclipse,68000000,300531751,405571077,706102828
"May 31, 2002",2002,The Sum of All Fears,68000000,118471320,75028680,193500000
"Jun 26, 2015",2015,Ted 2,68000000,81476385,135737758,217214143
"Jul 13, 2001",2001,The Score,68000000,71069884,42472207,113542091
"Feb 25, 2011",2011,Hall Pass,68000000,45060734,42112741,87173475
"Nov 22, 1995",1995,Money Train,68000000,35324232,41900000,77224232
"Mar 21, 2003",2003,Dreamcatcher,68000000,33685268,42000000,75685268
"Aug 6, 1999",1999,Mystery Men,68000000,29762011,3700000,33462011
"Nov 5, 1999",1999,The Insider,68000000,28965197,31300000,60265197
"Dec 22, 2017",2017,Downsizing,68000000,24449754,30013217,54462971
"Mar 2, 2012",2012,Doctor Seuss' The Lorax,67500000,214030500,136946253,350976753
"Oct 10, 2008",2008,Body of Lies,67500000,39394666,79161864,118556530
"Jun 22, 2012",2012,Abraham Lincoln: Vampire Hunter,67500000,37519139,99970591,137489730
"Sep 20, 1996",1996,Last Man Standing,67000000,18115927,0,18115927
"Aug 17, 2007",2007,The Last Legion,67000000,5932060,19425711,25357771
"Apr 30, 1999",1999,Entrapment,66000000,87707396,123992604,211700000
"Jun 19, 1998",1998,The X Files: Fight the Future,66000000,83898313,105278110,189176423
"Mar 14, 2014",2014,Need for Speed,66000000,43568507,150601112,194169619
"Jul 24, 1998",1998,Saving Private Ryan,65000000,216335085,268700000,485035085
"Dec 15, 2000",2000,What Women Want,65000000,182805123,191300000,374105123
"Nov 9, 2012",2012,Lincoln,65000000,182207973,91138308,273346281
"Mar 15, 2002",2002,Ice Age,65000000,176387405,209728938,386116343
"Jun 30, 1995",1995,Apollo 13,65000000,173772767,162029504,335802271
"Mar 31, 1999",1999,The Matrix,65000000,171479930,292037453,463517383
"Jul 13, 2018",2018,Hotel Transylvania 3: Summer Vacation,65000000,167500092,359579870,527079962
"Dec 25, 2012",2012,Les Miserables,65000000,148809770,293359282,442169052
"Nov 1, 2002",2002,The Santa Clause 2,65000000,139225854,33600000,172825854
"Jun 1, 1990",1990,Total Recall,65000000,119394839,142005161,261400000
"Dec 18, 1998",1998,You've Got Mail,65000000,115821495,134978505,250800000
"Dec 25, 2014",2014,Unbroken,65000000,115637895,47889929,163527824
"Jun 5, 2015",2015,Spy!,65000000,110825712,121760036,232585748
"Nov 5, 2010",2010,Due Date,65000000,100539043,111200000,211739043
"Jul 25, 2008",2008,Step Brothers,65000000,100468793,28000000,128468793
"Dec 15, 1995",1995,Jumanji,65000000,100458310,162300000,262758310
"Jul 17, 1998",1998,The Mask of Zorro,65000000,93828745,139871255,233700000
"Aug 4, 2000",2000,Space Cowboys,65000000,90454043,38420000,128874043
"Dec 19, 2014",2014,Annie,65000000,85911262,53918363,139829625
"May 28, 1993",1993,Cliffhanger,65000000,84049211,170950789,255000000
"Aug 12, 2016",2016,Peteâs Dragon,65000000,76233151,61535824,137768975
"Feb 9, 1996",1996,Broken Arrow,65000000,70645997,77700000,148345997
"Aug 9, 2006",2006,World Trade Center,65000000,70278893,93016761,163295654
"Jul 7, 2000",2000,The Kid,65000000,69688384,0,69688384
"Dec 19, 2003",2003,Mona Lisa Smile,65000000,63803100,77402069,141205169
"May 16, 2012",2012,The Dictator,65000000,59650222,120498675,180148897
"Jul 16, 1999",1999,Eyes Wide Shut,65000000,55691208,48576235,104267443
"Feb 17, 2012",2012,This Means War,65000000,54760791,102213766,156974557
"Feb 27, 2015",2015,Focus,65000000,53862963,114202737,168065700
"Dec 8, 2004",2004,Blade: Trinity,65000000,52397389,78955776,131353165
"Nov 21, 2012",2012,Red Dawn,65000000,44806783,3357367,48164150
"Dec 22, 2006",2006,We Are Marshall,65000000,43545364,0,43545364
"Sep 18, 2015",2015,Everest,65000000,43482270,177814791,221297061
"Sep 14, 2012",2012,Resident Evil: Retribution,65000000,42345531,198302098,240647629
"Mar 20, 1998",1998,Primary Colors,65000000,39017984,0,39017984
"Oct 15, 1999",1999,Fight Club,65000000,37030102,63821603,100851705
"Aug 22, 2008",2008,Death Race,65000000,36316032,36200787,72516819
"Oct 11, 1996",1996,The Long Kiss Goodnight,65000000,33447612,0,33447612
"Dec 8, 2000",2000,Proof of Life,65000000,32598931,30162074,62761005
"Nov 11, 2005",2005,Zathura,65000000,28045540,30500000,58545540
"Nov 26, 2003",2003,The Missing,65000000,26900336,11353097,38253433
"Jan 14, 2005",2005,Elektra,65000000,24409722,32414911,56824633
"Oct 23, 2009",2009,Astro Boy,65000000,19551067,22085176,41636243
"Jan 24, 2014",2014,"I, Frankenstein",65000000,19075290,55500000,74575290
"May 24, 1991",1991,Hudson Hawk,65000000,17218916,0,17218916
"Aug 22, 2014",2014,Sin City: A Dame to Kill For,65000000,13757804,26893038,40650842
"Dec 25, 2016",2016,Live by Night,65000000,10378555,11395877,21774432
"Oct 27, 2000",2000,Lucky Numbers,65000000,10014234,0,10014234
"Sep 23, 2005",2005,Oliver Twist,65000000,2070920,24600000,26670920
"Sep 4, 2015",2015,Tian jiang xiong shi,65000000,74070,122445804,122519874
"Oct 26, 2018",2018,Air Strike,65000000,0,516279,516279
"Jul 14, 2006",2006,Little Man,64000000,58636047,43000000,101636047
"Oct 8, 1999",1999,Random Hearts,64000000,31054924,32145076,63200000
"Dec 27, 2006",2006,Perfume: The Story of a Murderer,63700000,2223293,131380170,133603463
"Jun 11, 1993",1993,Jurassic Park,63000000,395708305,643104279,1038812584
"Jul 25, 2002",2002,Austin Powers in Goldmember,63000000,213117789,83220874,296338663
"Apr 1, 2011",2011,Hop,63000000,108085305,80572288,188657593
"Sep 15, 2017",2017,American Assassin,63000000,36249674,32060466,68310140
"Jun 24, 1994",1994,Wyatt Earp,63000000,25052000,0,25052000
"Aug 3, 1994",1994,Clear and Present Danger,62000000,122012656,85487344,207500000
"Apr 21, 2000",2000,U-571,62000000,77086030,50544000,127630030
"Nov 17, 1995",1995,The American President,62000000,60022813,47800000,107822813
"Dec 25, 2015",2015,The Hateful Eight,62000000,54117416,93747470,147864886
"Jun 20, 2008",2008,The Love Guru,62000000,32235793,7923224,40159017
"Feb 23, 2001",2001,3000 Miles to Graceland,62000000,15738632,2970216,18708848
"Oct 3, 2014",2014,Gone Girl,61000000,167767189,200800000,368567189
"Mar 30, 2007",2007,Blades of Glory,61000000,118594548,27000000,145594548
"Sep 18, 2015",2015,Maze Runner: The Scorch Trials,61000000,81697192,228868970,310566162
"Aug 2, 2013",2013,2 Guns,61000000,75612460,56880555,132493015
"Jan 26, 2018",2018,Maze Runner: The Death Cure,61000000,58032443,207846093,265878536
"Jan 11, 2019",2019,A Dogâs Way Home,61000000,41952715,39196974,81149689
"Feb 19, 2016",2016,Mei Ren Yu,60720000,3229457,551287214,554516671
"Dec 22, 2004",2004,Meet the Fockers,60000000,279167575,237400000,516567575
"Feb 7, 2014",2014,The Lego Movie,60000000,257784718,199944670,457729388
"Mar 9, 2007",2007,300,60000000,210614939,243546996,454161935
"Mar 2, 2007",2007,Wild Hogs,60000000,168213584,85341799,253555383
"Dec 25, 2008",2008,Marley & Me,60000000,143153751,104658260,247812011
"Dec 10, 1999",1999,The Green Mile,60000000,136801374,153900000,290701374
"Jun 5, 1998",1998,The Truman Show,60000000,125618201,138500000,264118201
"Sep 9, 2016",2016,Sully,60000000,125070033,113454523,238524556
"Jun 14, 2002",2002,The Bourne Identity,60000000,121468960,92888411,214357371
"Oct 9, 2009",2009,Couples Retreat,60000000,109205660,63244763,172450423
"Nov 17, 1995",1995,Goldeneye,60000000,106429941,250000000,356429941
"May 30, 2003",2003,The Italian Job,60000000,106126012,70136827,176262839
"May 9, 2003",2003,Daddy Day Care,60000000,104148781,60136806,164285587
"Jun 18, 1999",1999,The General's Daughter,60000000,102705852,47000000,149705852
"Dec 18, 1998",1998,The Prince of Egypt,60000000,101413188,117200000,218613188
"Aug 6, 2004",2004,Collateral,60000000,100170152,117500000,217670152
"Jul 4, 2001",2001,Cats & Dogs,60000000,93375151,107324849,200700000
"Dec 20, 2002",2002,Two Weeks Notice,60000000,93354918,105688391,199043309
"Oct 2, 1998",1998,Antz,60000000,90757863,61700000,152457863
"Apr 19, 2002",2002,The Scorpion King,60000000,90580000,75310634,165890634
"Oct 15, 2010",2010,Red,60000000,90380162,106059531,196439693
"Mar 5, 2004",2004,Starsky & Hutch,60000000,88200225,82000000,170200225
"Jun 27, 1990",1990,Days of Thunder,60000000,82670733,75000000,157670733
"Dec 21, 2005",2005,Cheaper by the Dozen 2,60000000,82571173,52444157,135015330
"Aug 13, 2010",2010,Eat Pray Love,60000000,80574010,126024779,206598789
"Dec 21, 2012",2012,Jack Reacher,60000000,80070736,137300000,217370736
"Apr 23, 2004",2004,Man on Fire,60000000,77906816,53061763,130968579
"Dec 22, 2000",2000,The Family Man,60000000,75764085,48951778,124715863
"Sep 9, 2011",2011,Contagion,60000000,75658097,61893497,137551594
"Dec 22, 1999",1999,Any Given Sunday,60000000,75530832,24700000,100230832
"May 15, 1998",1998,The Horse Whisperer,60000000,75383563,111500000,186883563
"Feb 6, 2009",2009,Coraline,60000000,75286229,50750828,126037057
"Oct 1, 2004",2004,Ladder 49,60000000,74541707,27791141,102332848
"Jul 28, 1999",1999,Deep Blue Sea,60000000,73648228,91400000,165048228
"Oct 28, 2009",2009,Michael Jackson's This Is It,60000000,72091016,180000000,252091016
"Jan 17, 2003",2003,Kangaroo Jack,60000000,66723216,24000000,90723216
"Jun 13, 2008",2008,The Happening,60000000,64506874,98271510,162778384
"Mar 4, 2016",2016,London Has Fallen,60000000,62524260,132669825,195194085
"Apr 7, 2000",2000,Rules of Engagement,60000000,61322858,10397073,71719931
"Mar 10, 2006",2006,The Shaggy Dog,60000000,61123569,26000000,87123569
"Nov 22, 1996",1996,Jingle All the Way,60000000,60592389,69240000,129832389
"Apr 2, 2004",2004,Hellboy,60000000,59623958,40200000,99823958
"Oct 21, 2016",2016,Jack Reacher: Never Go Back,60000000,58697076,101249413,159946489
"May 25, 2017",2017,Baywatch,60000000,58060186,117803597,175863783
"Dec 25, 1998",1998,A Civil Action,60000000,56709981,0,56709981
"Dec 25, 2015",2015,Joy,60000000,56451232,44682827,101134059
"Aug 17, 2012",2012,ParaNorman,60000000,56003051,52116611,108119662
"Nov 14, 1997",1997,The Jackal,60000000,54956941,104400000,159356941
"Dec 25, 2003",2003,Paycheck,60000000,53789313,45030476,98819789
"Mar 1, 1996",1996,Up Close & Personal,60000000,51045801,49600000,100645801
"Dec 19, 2008",2008,The Tale of Despereaux,60000000,50877145,39605172,90482317
"Sep 26, 2014",2014,The Boxtrolls,60000000,50837305,61108946,111946251
"Aug 4, 2017",2017,The Dark Tower,60000000,50701325,62760202,113461527
"Sep 27, 2002",2002,The Tuxedo,60000000,50586000,53843625,104429625
"Jan 17, 2014",2014,Jack Ryan: Shadow Recruit,60000000,50577412,80800000,131377412
"Jul 14, 1995",1995,Under Siege 2: Dark Territory,60000000,50024083,54300000,104324083
"Mar 24, 2005",2005,Miss Congeniality 2: Armed and Fabulous,60000000,48478006,52904390,101382396
"Dec 25, 2018",2018,Vice,60000000,47836282,23046889,70883171
"Nov 26, 1997",1997,Alien: Resurrection,60000000,47795018,112904982,160700000
"Mar 23, 2007",2007,Shooter,60000000,47003582,48534978,95538560
"Oct 16, 1998",1998,Practical Magic,60000000,46850558,21486439,68336997
"Jan 11, 2013",2013,Gangster Squad,60000000,46000903,58100000,104100903
"Apr 7, 2017",2017,Smurfs: The Lost Village,60000000,45020282,152558304,197578586
"Oct 12, 2018",2018,First Man,60000000,44936545,60267280,105203825
"Jun 19, 2009",2009,Year One,60000000,43337279,14267444,57604723
"Jan 29, 2010",2010,Edge of Darkness,60000000,43313890,39498566,82812456
"Dec 13, 2002",2002,Star Trek: Nemesis,60000000,43254409,24058417,67312826
"Feb 19, 2002",2002,Reign of Fire,60000000,43061982,39088201,82150183
"Nov 20, 2009",2009,Planet 51,60000000,42194060,66802053,108996113
"Mar 20, 2009",2009,Duplicity,60000000,40572825,40506741,81079566
"Sep 12, 2008",2008,Righteous Kill,60000000,40081410,38400000,78481410
"Dec 11, 2009",2009,Invictus,60000000,37491364,87022647,124514011
"Apr 17, 2009",2009,State of Play,60000000,37017955,51814255,88832210
"Feb 12, 1999",1999,My Favorite Martian,60000000,36850101,0,36850101
"Apr 21, 2006",2006,The Sentinel,60000000,36280697,41800000,78080697
"Sep 21, 2012",2012,Trouble with the Curve,60000000,35763137,12055776,47818913
"Oct 10, 2003",2003,Intolerable Cruelty,60000000,35327628,86000000,121327628
"Jan 10, 1997",1997,The Relic,60000000,33956608,0,33956608
"Apr 3, 1998",1998,Mercury Rising,60000000,32983332,0,32983332
"Sep 15, 2000",2000,Almost Famous,60000000,32522352,14848839,47371191
"Feb 8, 2019",2019,Cold Pursuit,60000000,32138862,30460297,62599159
"Dec 6, 2002",2002,Analyze That,60000000,32122249,22872508,54994757
"Apr 24, 2009",2009,The Soloist,60000000,31853584,6668866,38522450
"Aug 21, 2013",2013,The Mortal Instruments: City of Bones,60000000,31165421,44800146,75965567
"Nov 3, 2000",2000,The Legend of Bagger Vance,60000000,30695227,8540259,39235486
"Feb 22, 2002",2002,Dragonfly,60000000,30063805,0,30063805
"May 13, 2011",2011,Priest,60000000,29136626,55017400,84154026
"Jun 16, 2006",2006,Garfield: A Tail of Two Kitties,60000000,28426747,119558626,147985373
"Apr 29, 2005",2005,XXX: State of the Union,60000000,26873932,44200000,71073932
"Aug 15, 1997",1997,Event Horizon,60000000,26673242,0,26673242
"Jul 2, 2003",2003,Sinbad: Legend of the Seven Seas,60000000,26483452,54284432,80767884
"Jul 8, 2005",2005,Dark Water,60000000,25473093,24000000,49473093
"Aug 14, 1998",1998,The Avengers,60000000,23385416,25200000,48585416
"Sep 15, 2006",2006,The Black Dahlia,60000000,22672813,26565712,49238525
"Mar 26, 1999",1999,EDtv,60000000,22508689,12811000,35319689
"Dec 25, 2008",2008,The Spirit,60000000,19806188,19200000,39006188
"Oct 19, 2001",2001,The Last Castle,60000000,18208078,2333590,20541668
"Jan 23, 2009",2009,Inkheart,60000000,17303424,49352514,66655938
"Jan 14, 2000",2000,Supernova,60000000,14218868,597626,14816494
"Sep 22, 2006",2006,Flyboys,60000000,13090630,1725749,14816379
"Feb 14, 2014",2014,Winterâs Tale,60000000,12600231,16974802,29575033
"Oct 9, 1998",1998,Holy Man,60000000,12069719,0,12069719
"Jul 11, 2008",2008,Meet Dave,60000000,11803254,38845552,50648806
"Aug 12, 2005",2005,The Great Raid,60000000,10166502,430568,10597070
"Feb 24, 2017",2017,Rock Dog,60000000,9420546,14727942,24148488
"Jan 23, 2015",2015,Mortdecai,60000000,7696134,22700000,30396134
"Jan 11, 2008",2008,In the Name of the King: A Dungeon Siege Tale,60000000,4775656,8457564,13233220
"Oct 24, 2003",2003,Beyond Borders,60000000,4426297,7000793,11427090
"Feb 5, 2016",2016,Xi You Ji zhi Sun Wu Kong San Da Bai Gu Jing,60000000,709982,193348521,194058503
"Dec 11, 2015",2015,The Ridiculous 6,60000000,0,0,0
"Nov 8, 2019",2019,Midway,59500000,0,0,0
"Mar 23, 2018",2018,Sherlock Gnomes,59000000,43242871,44284780,87527651
"Jan 25, 2019",2019,The Kid Who Would Be King,59000000,16790790,11557656,28348446
"Feb 12, 2016",2016,Deadpool,58000000,363070709,437954884,801025593
"Dec 25, 2014",2014,American Sniper,58000000,350126372,197200000,547326372
"Oct 16, 2015",2015,Goosebumps,58000000,80069458,78835866,158905324
"May 25, 1988",1988,Rambo III,58000000,53715611,135000000,188715611
"Dec 15, 1995",1995,Sabrina,58000000,53458319,33641681,87100000
"Jan 20, 2012",2012,Red Tails,58000000,49876377,489121,50365498
"Sep 16, 2005",2005,Just Like Heaven,58000000,48318130,52368953,100687083
"Jun 7, 2013",2013,The Internship,58000000,44672764,49000000,93672764
"Apr 28, 2000",2000,The Flintstones in Viva Rock Vegas,58000000,35231365,24200000,59431365
"Apr 4, 2008",2008,Leatherheads,58000000,31373938,9974690,41348628
"Mar 24, 2017",2017,Life,58000000,30234022,70695644,100929666
"Dec 18, 2009",2009,Did You Hear About the Morgans?,58000000,29580087,50900479,80480566
"Dec 12, 2008",2008,"Che, Part 1: The Argentine",58000000,1802521,29824849,31627370
"May 30, 2008",2008,Sex and the City,57500000,152647258,262600000,415247258
"Sep 10, 2010",2010,Resident Evil: Afterlife,57500000,60128566,235745624,295874190
"Jun 15, 2012",2012,That's My Boy,57500000,36931089,21154146,58085235
"Oct 17, 1997",1997,Devil's Advocate,57000000,61007424,92000000,153007424
"Feb 17, 2012",2012,Ghost Rider: Spirit of Vengeance,57000000,51774002,97443353,149217355
"May 31, 1996",1996,Dragonheart,57000000,51364680,53000000,104364680
"Nov 12, 2004",2004,After the Sunset,57000000,28328132,10000982,38329114
"Aug 17, 2001",2001,Captain Corelli's Mandolin,57000000,25528495,36569000,62097495
"Dec 25, 2014",2014,Into the Woods,56200000,128002372,85114029,213116401
"Apr 11, 2003",2003,Anger Management,56000000,135560942,60100000,195660942
"Mar 4, 2005",2005,The Pacifier,56000000,113006880,85000000,198006880
"Apr 2, 2004",2004,Walking Tall,56000000,46213824,1100000,47313824
"Jan 22, 2016",2016,Zhuo yao ji,56000000,32766,359462825,359495591
"Jul 6, 1994",1994,Forrest Gump,55000000,330151138,349699499,679850637
"Dec 14, 2007",2007,Alvin and the Chipmunks,55000000,217326974,145278059,362605033
"Nov 2, 2018",2018,Bohemian Rhapsody,55000000,216303339,678682003,894985342
"Feb 11, 2005",2005,Hitch,55000000,177784257,189000000,366784257
"Oct 6, 2000",2000,Meet the Parents,55000000,166225040,164200000,330425040
"Dec 15, 2006",2006,The Pursuit of Happyness,55000000,162586036,144725057,307311093
"Jun 10, 1995",1995,Pocahontas,55000000,141579773,205520227,347100000
"Dec 15, 1978",1978,Superman,55000000,134218018,165981982,300200000
"Jun 28, 1996",1996,The Nutty Professor,55000000,128814019,145000000,273814019
"Feb 10, 2017",2017,Fifty Shades Darker,55000000,114434010,266964482,381398492
"Oct 11, 2013",2013,Captain Phillips,55000000,107136417,113511767,220648184
"Jul 16, 1997",1997,George Of The Jungle,55000000,105263257,69200000,174463257
"Aug 1, 2003",2003,American Wedding,55000000,104354205,22070910,126425115
"Nov 10, 2017",2017,Murder on the Orient Express,55000000,102826543,243096187,345922730
"Sep 26, 2014",2014,The Equalizer,55000000,101530738,91372886,192903624
"Feb 9, 2018",2018,Fifty Shades Freed,55000000,100407760,270942859,371350619
"May 26, 1995",1995,Casper,55000000,100328194,181971806,282300000
"Apr 9, 2010",2010,Date Night,55000000,98711404,53557629,152269033
"Dec 13, 2002",2002,Maid in Manhattan,55000000,93932896,69905321,163838217
"May 12, 1995",1995,Crimson Tide,55000000,91387195,68000000,159387195
"Sep 23, 2005",2005,Flightplan,55000000,89706988,124685916,214392904
"Dec 9, 1994",1994,Disclosure,55000000,83015089,129184911,212200000
"Apr 10, 1998",1998,City of Angels,55000000,78750909,120000000,198750909
"Jan 16, 2015",2015,Paddington,55000000,76223578,182565519,258789097
"Apr 28, 2006",2006,R.V.,55000000,71724497,15748527,87473024
"Oct 28, 1994",1994,Stargate,55000000,71565669,125000000,196565669
"Oct 10, 2003",2003,Kill Bill: Volume 1,55000000,70098138,106371290,176469428
"Jun 17, 2011",2011,Mr. Poppers's Penguins,55000000,68224452,121400000,189624452
"Aug 13, 1999",1999,Bowfinger,55000000,66458769,32241000,98699769
"Apr 16, 2004",2004,Kill Bill: Volume 2,55000000,66207920,87328062,153535982
"Dec 22, 1989",1989,Tango & Cash,55000000,63408614,0,63408614
"Jul 31, 1992",1992,Death Becomes Her,55000000,58422650,90600000,149022650
"May 26, 2000",2000,Shanghai Noon,55000000,56932305,14257530,71189835
"Mar 15, 1996",1996,Executive Decision,55000000,56679192,65400000,122079192
"Nov 1, 2013",2013,Free Birds,55000000,55750480,54636592,110387072
"May 22, 1992",1992,Alien 3,55000000,54927174,103572826,158500000
"Apr 18, 2008",2008,The Forbidden Kingdom,55000000,52075270,77000000,129075270
"Dec 22, 2004",2004,The Phantom of the Opera,55000000,51225796,102544256,153770052
"Mar 21, 2014",2014,Muppets Most Wanted,55000000,51178893,28133408,79312301
"Dec 25, 1996",1996,Evita,55000000,50047179,101900000,151947179
"Aug 19, 2016",2016,Kubo and the Two Strings,55000000,48023088,29525034,77548122
"Sep 25, 1998",1998,Ronin,55000000,41610884,29081217,70692101
"Nov 24, 2010",2010,Burlesque,55000000,39440655,51112020,90552675
"Oct 11, 1996",1996,The Ghost and the Darkness,55000000,38564422,0,38564422
"Oct 24, 2008",2008,Changeling,55000000,35739802,78065778,113805580
"Jul 27, 2012",2012,The Watch,55000000,34353000,32777045,67130045
"Mar 14, 2003",2003,The Hunted,55000000,34234008,12979087,47213095
"Jun 4, 1999",1999,Instinct,55000000,34105207,0,34105207
"Dec 12, 2003",2003,Stuck On You,55000000,33832741,29704423,63537164
"Feb 29, 2008",2008,Semi-Pro,55000000,33479698,10500665,43980363
"Feb 23, 2018",2018,Annihilation,55000000,32732301,10338614,43070915
"Oct 16, 2015",2015,Crimson Peak,55000000,31090320,43876534,74966854
"Apr 27, 2012",2012,The Pirates! Band of Misfits,55000000,31051126,105092479,136143605
"Dec 2, 2005",2005,Aeon Flux,55000000,25857987,28055586,53913573
"Aug 2, 1996",1996,Chain Reaction,55000000,21226204,38983130,60209334
"Aug 16, 1996",1996,The Fan,55000000,18582965,0,18582965
"Oct 12, 2007",2007,Elizabeth: The Golden Age,55000000,16285240,58585626,74870866
"Jun 12, 2009",2009,Imagine That,55000000,16222392,6215752,22438144
"Feb 21, 2003",2003,Gods and Generals,55000000,12882934,41002,12923936
"Jan 10, 1997",1997,Turbulence,55000000,11532774,0,11532774
"Feb 1, 2013",2013,Bullet to the Head,55000000,9489829,13108140,22597969
"Sep 22, 2006",2006,All the King's Men,55000000,7221458,2300000,9521458
"Jul 30, 2004",2004,Thunderbirds,55000000,6768055,21463389,28231444
"Nov 26, 2004",2004,Un long dimanche de fianÃ§ailles,55000000,6167817,63591479,69759296
"May 4, 2007",2007,Lucky You,55000000,5755286,766543,6521829
"Jul 22, 1998",1998,Lolita,55000000,1147784,0,1147784
"Sep 20, 2002",2002,Eye See You,55000000,79161,1728829,1807990
"Jun 19, 1981",1981,Superman II,54000000,108185706,0,108185706
"Mar 22, 2002",2002,Blade 2,54000000,81676888,72661713,154338601
"Jul 14, 2006",2006,"You, Me and Dupree",54000000,75802010,54600000,130402010
"Dec 19, 2008",2008,Seven Pounds,54000000,69951824,96665504,166617328
"Dec 25, 1990",1990,The Godfather: Part III,54000000,66520529,0,66520529
"Oct 14, 2005",2005,Elizabethtown,54000000,26850426,23868947,50719373
"Aug 1, 2003",2003,Gigli,54000000,6087542,1038460,7126002
"Jun 16, 2000",2000,Shaft,53012938,70327868,36862240,107190108
"Aug 5, 2005",2005,The Dukes of Hazzard,53000000,80270227,29578234,109848461
"Oct 16, 2009",2009,Law Abiding Citizen,53000000,73357727,57802054,131159781
"Sep 18, 2015",2015,Black Mass,53000000,62575678,36262194,98837872
"Nov 14, 1997",1997,Anastasia,53000000,58403409,81397687,139801096
"May 18, 2001",2001,Moulin Rouge,53000000,57386369,121814219,179200588
"Nov 2, 2001",2001,Domestic Disturbance,53000000,45207112,9000000,54207112
"Oct 20, 2006",2006,Flags of Our Fathers,53000000,33602376,30055565,63657941
"Apr 6, 2007",2007,Grindhouse,53000000,25031037,25156752,50187789
"Oct 16, 1998",1998,Beloved,53000000,22852487,0,22852487
"Dec 19, 2012",2012,Zero Dark Thirty,52500000,95720716,38891719,134612435
"Dec 25, 2002",2002,Catch Me if You Can,52000000,164606800,191005491,355612291
"Jul 18, 2008",2008,Mamma Mia!,52000000,144130063,471618709,615748772
"Jun 2, 2006",2006,The Break-Up,52000000,118703275,87024032,205727307
"Feb 12, 2010",2010,Valentine's Day,52000000,110485654,107083674,217569328
"Nov 22, 1995",1995,Casino,52000000,42438300,67961700,110400000
"Aug 5, 2011",2011,The Change-Up,52000000,37243418,38753649,75997067
"Dec 23, 1998",1998,The Thin Red Line,52000000,36400491,61308543,97709034
"Dec 22, 1999",1999,Man on the Moon,52000000,34580635,12827000,47407635
"Feb 5, 2010",2010,From Paris With Love,52000000,24077427,29061741,53139168
"Apr 16, 2003",2003,Bulletproof Monk,52000000,23010607,0,23010607
"Jun 23, 2000",2000,"Me, Myself & Irene",51000000,90570999,58700000,149270999
"Aug 4, 2006",2006,Barnyard: The Original Party Animals,51000000,72779000,45804844,118583844
"Aug 17, 2018",2018,Alpha,51000000,35851379,63773494,99624873
"Nov 22, 2006",2006,Deck the Halls,51000000,35093569,11722238,46815807
"Mar 4, 2011",2011,The Adjustment Bureau,50200000,62495645,64435680,126931325
"Nov 20, 2009",2009,The Twilight Saga: New Moon,50000000,296623634,390934093,687557727
"May 18, 2001",2001,Shrek,50000000,267655011,224157783,491812794
"Jun 29, 2012",2012,Ted,50000000,218665740,337350887,556016627
"Jun 13, 2014",2014,22 Jump Street,50000000,191719337,139614539,331333876
"Jun 14, 1991",1991,Robin Hood: Prince of Thieves,50000000,165493908,225006092,390500000
"Dec 13, 1996",1996,Jerry Maguire,50000000,153952592,120047408,274000000
"Dec 25, 2015",2015,Daddyâs Home,50000000,150357137,92400000,242757137
"Dec 24, 1997",1997,As Good as it Gets,50000000,148478011,165633912,314111923
"Dec 25, 1998",1998,Patch Adams,50000000,135014968,67158032,202173000
"Jun 17, 2016",2016,Central Intelligence,50000000,127440871,89753934,217194805
"Dec 18, 2013",2013,Anchorman 2: The Legend Continues,50000000,127352707,44833047,172185754
"Jun 10, 2011",2011,Super 8,50000000,127004179,130968566,257972745
"Jun 28, 2002",2002,Mr. Deeds,50000000,126293452,44976083,171269535
"Mar 17, 2000",2000,Erin Brockovich,50000000,125548685,132256558,257805243
"Nov 21, 2018",2018,Creed II,50000000,115715889,97875633,213591522
"Feb 9, 2018",2018,Peter Rabbit,50000000,115234093,231902384,347136477
"Feb 7, 2003",2003,How to Lose a Guy in 10 Days,50000000,105807520,73083262,178890782
"Nov 11, 1994",1994,Interview with the Vampire: The Vampire Chronicles,50000000,105264608,118300000,223564608
"Dec 14, 2018",2018,The Mule,50000000,103804407,67053269,170857676
"Dec 19, 2008",2008,Yes Man,50000000,97690976,128300000,225990976
"Feb 28, 2014",2014,Non-Stop,50000000,91742160,130640895,222383055
"Dec 25, 1998",1998,Stepmom,50000000,91137662,68607617,159745279
"Aug 9, 2013",2013,Disney Planes,50000000,90282580,147776989,238059569
"Mar 10, 2006",2006,Failure to Launch,50000000,88715192,39687709,128402901
"Mar 24, 2006",2006,Inside Man,50000000,88634237,97164028,185798265
"Jul 28, 2017",2017,The Emoji Movie,50000000,86089513,130472799,216562312
"Jul 29, 2011",2011,"Crazy, Stupid, Love",50000000,84351197,62791131,147142328
"Dec 22, 2017",2017,The Post,50000000,81903458,97845422,179748880
"Feb 5, 1999",1999,Payback,50000000,81526121,80100000,161626121
"Jun 9, 1995",1995,Congo,50000000,81022333,71000000,152022333
"Mar 20, 2009",2009,Knowing,50000000,79957634,106492683,186450317
"Mar 18, 2005",2005,The Ring Two,50000000,75941727,86000000,161941727
"Dec 23, 2011",2011,We Bought a Zoo,50000000,75624550,43104523,118729073
"Sep 23, 2011",2011,Moneyball,50000000,75605492,35695343,111300835
"Jun 11, 2004",2004,Garfield: The Movie,50000000,75367693,132726857,208094550
"Nov 24, 2004",2004,Christmas with the Kranks,50000000,73701902,22767285,96469187
"Mar 17, 2006",2006,V for Vendetta,50000000,70511035,59703127,130214162
"Mar 10, 1995",1995,Outbreak,50000000,67823573,122200000,190023573
"Mar 13, 2009",2009,Race to Witch Mountain,50000000,67172595,37931189,105103784
"Sep 24, 2004",2004,The Forgotten,50000000,66711892,50500000,117211892
"Jun 22, 2005",2005,Herbie: Fully Loaded,50000000,66010682,78100000,144110682
"Feb 7, 2003",2003,Shanghai Knights,50000000,60470220,27846615,88316835
"Jul 18, 2014",2014,Planes: Fire and Rescue,50000000,59157732,97241912,156399644
"Feb 10, 2006",2006,Curious George,50000000,58640119,12412485,71052604
"Apr 6, 2012",2012,American Reunion,50000000,56758835,180040376,236799211
"Jan 25, 2013",2013,Hansel & Gretel: Witch Hunters,50000000,55703475,159246241,214949716
"Feb 18, 2011",2011,I am Number Four,50000000,55100437,91094722,146195159
"Sep 28, 2001",2001,Donât Say a Word,50000000,54997476,49490907,104488383
"Jan 15, 2016",2016,13 Hours: The Secret Soldiers of Benghazi,50000000,52853219,16558151,69411370
"May 8, 2002",2002,Unfaithful,50000000,52752475,66362019,119114494
"Sep 29, 2017",2017,American Made,50000000,51342000,84227212,135569212
"Nov 23, 2005",2005,Syriana,50000000,50824620,41866339,92690959
"Sep 10, 2004",2004,Resident Evil: Apocalypse,50000000,50740078,74428656,125168734
"Oct 17, 2014",2014,The Book of Life,50000000,50151543,47500000,97651543
"Feb 14, 1997",1997,Absolute Power,50000000,50068310,0,50068310
"Feb 10, 2006",2006,Firewall,50000000,48751189,34000000,82751189
"Sep 12, 1997",1997,The Game,50000000,48265581,32104389,80369970
"Aug 22, 1997",1997,G.I. Jane,50000000,48169156,0,48169156
"Aug 8, 2014",2014,Into the Storm,50000000,47602194,102827177,150429371
"Oct 10, 2014",2014,The Judge,50000000,47119388,29000000,76119388
"Apr 21, 2006",2006,Silent Hill,50000000,46982632,47721595,94704227
"Aug 11, 2000",2000,The Replacements,50000000,44737059,5317452,50054511
"Jul 29, 1998",1998,The Negotiator,50000000,44705766,4400000,49105766
"Aug 19, 2016",2016,War Dogs,50000000,43034523,43199980,86234503
"May 25, 1994",1994,Beverly Hills Cop III,50000000,42586861,76594077,119180938
"Jun 15, 1990",1990,Gremlins 2: The New Batch,50000000,41476097,0,41476097
"Sep 26, 1997",1997,The Peacemaker,50000000,41263140,21704228,62967368
"Oct 3, 2003",2003,Out of Time,50000000,41083108,14406718,55489826
"Nov 12, 2004",2004,Bridget Jones: The Edge Of Reason,50000000,40203020,223691531,263894551
"Feb 11, 2000",2000,The Beach,50000000,39778599,0,39778599
"Jun 10, 2005",2005,The Adventures of Sharkboy and Lavagirl in 3-D,50000000,39177684,30248282,69425966
"Feb 18, 1994",1994,On Deadly Ground,50000000,38590458,0,38590458
"Nov 25, 2009",2009,Ninja Assassin,50000000,38122883,24087009,62209892
"May 28, 2004",2004,Raising Helen,50000000,37485528,12443152,49928680
"May 20, 2016",2016,The Nice Guys,50000000,36261763,23334984,59596747
"Sep 17, 1999",1999,For Love of the Game,50000000,35188640,10924000,46112640
"Dec 11, 1998",1998,Jack Frost,50000000,34645374,0,34645374
"Jun 4, 2010",2010,Marmaduke,50000000,33644788,56251142,89895930
"Jun 28, 1996",1996,Striptease,50000000,33109743,80200000,113309743
"Oct 15, 2010",2010,Hereafter,50000000,32746941,75913329,108660270
"Apr 19, 2002",2002,Murder by Numbers,50000000,31874869,24768398,56643267
"Oct 6, 1995",1995,Assassins,50000000,30306268,53000000,83306268
"Feb 12, 2016",2016,Zoolander 2,50000000,28848693,26500000,55348693
"Jan 16, 2009",2009,Defiance,50000000,28644813,24342941,52987754
"Feb 9, 2007",2007,Hannibal Rising,50000000,27669725,52913586,80583311
"Oct 15, 1999",1999,The Story of Us,50000000,27100030,0,27100030
"Mar 29, 2013",2013,The Host,50000000,26623701,37853350,64477051
"Mar 28, 2003",2003,Basic,50000000,26599248,15999250,42598498
"Mar 13, 2015",2015,Run All Night,50000000,26461644,40500000,66961644
"Aug 9, 2002",2002,Blood Work,50000000,26199517,0,26199517
"Feb 13, 2009",2009,The International,50000000,25450527,28400000,53850527
"Aug 9, 1996",1996,Escape from L.A.,50000000,25426861,0,25426861
"Feb 27, 2004",2004,Twisted,50000000,25195050,14924798,40119848
"Dec 10, 2004",2004,The Life Aquatic with Steve Zissou,50000000,24006726,10800000,34806726
"Aug 4, 1999",1999,The Iron Giant,50000000,23159305,8174612,31333917
"Apr 12, 2019",2019,Hellboy,50000000,21903748,18821744,40725492
"Apr 8, 2011",2011,Your Highness,50000000,21596445,4525193,26121638
"Sep 16, 2016",2016,Snowden,50000000,21587519,13793399,35380918
"Sep 30, 2011",2011,Dream House,50000000,21302340,20339826,41642166
"Jun 24, 2016",2016,Free State of Jones,50000000,20810036,2427216,23237252
"Sep 4, 2009",2009,Gamer,50000000,20534907,21467122,42002029
"Feb 25, 2005",2005,Man of the House,50000000,19699706,2400000,22099706
"Feb 21, 2003",2003,The Life of David Gale,50000000,19694635,9225553,28920188
"Feb 14, 2013",2013,Beautiful Creatures,50000000,19452138,40830738,60282876
"Sep 30, 2005",2005,Into the Blue,50000000,18782227,23200000,41982227
"Sep 14, 2007",2007,Eastern Promises,50000000,17181265,38895823,56077088
"Jul 1, 1994",1994,Baby's Day Out,50000000,16581575,0,16581575
"Nov 12, 1999",1999,The Messenger: The Story of Joan of Arc,50000000,14271297,0,14271297
"Nov 3, 1995",1995,Fair Game,50000000,11497497,14600000,26097497
"Feb 25, 2011",2011,Drive Angry,50000000,10721033,30321550,41042583
"Nov 7, 1997",1997,Mad City,50000000,10561038,0,10561038
"Oct 13, 1995",1995,The Scarlet Letter,50000000,10359006,0,10359006
"Oct 14, 2005",2005,Domino,50000000,10169202,13404855,23574057
"Oct 13, 1995",1995,Jade,50000000,9812870,0,9812870
"Feb 27, 2009",2009,Street Fighter: The Legend of Chun-Li,50000000,8742261,3918026,12660287
"Mar 29, 2002",2002,Death to Smoochy,50000000,8355815,18247,8374062
"Feb 16, 2018",2018,Early Man,50000000,8267544,37018346,45285890
"Nov 13, 2009",2009,The Boat That Rocked,50000000,8017467,29455184,37472651
"Jan 30, 2004",2004,The Big Bounce,50000000,6471394,154721,6626115
"Mar 3, 2000",2000,What Planet Are You From?,50000000,6291602,0,6291602
"Apr 17, 2015",2015,Child 44,50000000,1224330,6779891,8004221
"Jan 23, 2009",2009,Outlander,50000000,166003,1084614,1250617
"Mar 15, 2013",2013,Upside Down,50000000,102118,26284921,26387039
"Oct 2, 2015",2015,Shanghai,50000000,46425,15459497,15505922
"Dec 31, 2020",2020,Hannibal the Conqueror,50000000,0,0,0
"Nov 8, 2019",2019,Arctic Dogs,50000000,0,0,0
"Nov 22, 2019",2019,The Rhythm Section,50000000,0,0,0
"Sep 20, 2019",2019,Ad Astra,49800000,0,0,0
"Nov 2, 2001",2001,The One,49000000,43905746,28783380,72689126
"Mar 6, 2015",2015,Chappie,49000000,31569268,73432788,105002056
"Jul 11, 1990",1990,The Adventures of Ford Fairlane,49000000,20423389,0,20423389
"Nov 16, 2012",2012,Anna Karenina,49000000,12816367,58188260,71004627
"May 24, 1989",1989,Indiana Jones and the Last Crusade,48000000,197171806,277000000,474171806
"Oct 18, 2002",2002,The Ring,48000000,129094024,119124462,248218486
"Dec 27, 2000",2000,Traffic,48000000,124107476,84192524,208300000
"Mar 29, 2002",2002,Panic Room,48000000,95308367,101000000,196308367
"Jan 9, 2015",2015,Taken 3,48000000,89256424,238400000,327656424
"Aug 6, 1999",1999,The Thomas Crown Affair,48000000,69304264,55000000,124304264
"Nov 16, 2018",2018,Instant Family,48000000,67363237,52372951,119736188
"Nov 5, 1999",1999,The Bone Collector,48000000,66488090,84975000,151463090
"Oct 1, 1999",1999,Three Kings,48000000,60652036,47100000,107752036
"Jan 22, 2010",2010,Tooth Fairy,48000000,60022256,52588130,112610386
"Aug 17, 2001",2001,Rat Race,48000000,56607223,30000000,86607223
"Sep 7, 2007",2007,3:10 to Yuma,48000000,53606916,17564909,71171825
"Aug 13, 2001",2001,K-PAX,48000000,50315140,0,50315140
"Dec 25, 2001",2001,Kate and Leopold,48000000,47095453,23842325,70937778
"Oct 20, 2000",2000,Bedazzled,48000000,37879996,52496228,90376224
"Jun 26, 1998",1998,Out of Sight,48000000,37562568,40000000,77562568
"Dec 14, 1984",1984,The Cotton Club,48000000,25928721,0,25928721
"Jan 25, 2008",2008,Rambo,47500000,42754105,69460426,112214531
"Jul 13, 2016",2016,The Infiltrator,47500000,15436808,5281296,20718104
"Jun 15, 1990",1990,Dick Tracy,47000000,103738726,59000000,162738726
"Nov 11, 2016",2016,Arrival,47000000,100546139,102581755,203127894
"Jun 14, 1996",1996,The Cable Guy,47000000,60240295,42585501,102825796
"Apr 22, 2009",2009,Earth,47000000,32011576,84761741,116773317
"Oct 19, 2001",2001,Riding in Cars with Boys,47000000,29781453,0,29781453
"Jan 5, 2007",2007,Happily N'Ever After,47000000,15849032,22074786,37923818
"Nov 27, 2002",2002,Solaris,47000000,14970038,0,14970038
"Jun 18, 2010",2010,Jonah Hex,47000000,10547117,475579,11022696
"Feb 23, 1996",1996,Mary Reilly,47000000,5707094,7192906,12900000
"Dec 23, 2016",2016,Silence,46500000,7100177,16626449,23726626
"Nov 1, 2013",2013,Mr. Nobody,46500000,3622,18632,22254
"Jun 20, 1997",1997,My Best Friend's Wedding,46000000,126813153,172110266,298923419
"Jul 20, 2001",2001,America's Sweethearts,46000000,93607673,67040820,160648493
"Nov 22, 1996",1996,Star Trek: First Contact,46000000,92027888,57972112,150000000
"May 24, 2002",2002,Insomnia,46000000,67263182,46359317,113622499
"Sep 20, 2013",2013,Prisoners,46000000,61002302,52400000,113402302
"Jul 12, 1996",1996,Courage Under Fire,46000000,59003384,41829761,100833145
"Sep 17, 1982",1982,Inchon,46000000,4408636,0,4408636
"Dec 31, 2010",2010,Arthur and the War of Two Worlds,45500000,347136,35833688,36180824
"Mar 21, 1997",1997,Liar Liar,45000000,181410615,121300000,302710615
"Nov 20, 1998",1998,A Bug's Life,45000000,162798565,200296754,363095319
"Oct 5, 2012",2012,Taken 2,45000000,139854287,237953117,377807404
"May 27, 1994",1994,The Flintstones,45000000,130531208,227968792,358500000
"Oct 24, 2003",2003,Scary Movie 3,45000000,110000082,45199918,155200000
"Dec 22, 2000",2000,Miss Congeniality,45000000,106807667,106613284,213420951
"Dec 22, 2017",2017,Pitch Perfect 3,45000000,104897530,80838882,185736412
"Jul 11, 2008",2008,Journey to the Center of the Earth,45000000,101704370,141476567,243180937
"Dec 17, 1993",1993,The Pelican Brief,45000000,100768056,87227803,187995859
"Aug 11, 2004",2004,The Princess Diaries 2: Royal Engagement,45000000,95149435,26922000,122071435
"Dec 25, 2007",2007,The Bucket List,45000000,93466502,81340943,174807445
"Jul 20, 1994",1994,The Client,45000000,92115211,25500000,117615211
"Nov 23, 2011",2011,The Muppets,45000000,88625922,72346000,160971922
"Jun 5, 1992",1992,Patriot Games,45000000,83287363,94812637,178100000
"May 13, 2005",2005,Monster-in-Law,45000000,82931301,73000000,155931301
"Oct 5, 2001",2001,Training Day,45000000,76261036,28244326,104505362
"Oct 7, 2016",2016,The Girl on the Train,45000000,75395035,98883179,174278214
"Dec 24, 1999",1999,Galaxy Quest,45000000,71423726,19100000,90523726
"Jul 4, 2001",2001,Scary Movie 2,45000000,71277420,69911681,141189101
"Aug 21, 1998",1998,Blade,45000000,70141876,61095812,131237688
"Jan 14, 2005",2005,Coach Carter,45000000,67264877,9400630,76665507
"Mar 19, 2010",2010,The Bounty Hunter,45000000,67061228,68747609,135808837
"Apr 12, 2002",2002,Changing Lanes,45000000,66790248,0,66790248
"Apr 11, 1997",1997,Anaconda,45000000,65598907,71400000,136998907
"Jan 20, 2006",2006,Underworld: Evolution,45000000,62318875,51098887,113417762
"Aug 4, 2000",2000,Coyote Ugly,45000000,60786269,53130205,113916474
"Nov 7, 2003",2003,Love Actually,45000000,59472278,189033022,248505300
"Aug 9, 1996",1996,Jack,45000000,58617334,0,58617334
"Oct 7, 1994",1994,The Specialist,45000000,57362581,0,57362581
"Dec 9, 2016",2016,Office Christmas Party,45000000,54767494,36555805,91323299
"Aug 16, 1996",1996,Tin Cup,45000000,53854588,22000000,75854588
"Nov 23, 2005",2005,"Yours, Mine and Ours",45000000,53359917,19000000,72359917
"May 13, 2005",2005,Kicking and Screaming,45000000,52842724,3000000,55842724
"Apr 29, 2005",2005,The Hitchhiker's Guide to the Galaxy,45000000,51019112,51727102,102746214
"Sep 21, 2007",2007,Resident Evil: Extinction,45000000,50648679,99222424,149871103
"Dec 25, 2004",2004,Fat Albert,45000000,48114556,449000,48563556
"Jul 6, 2012",2012,Savages,45000000,47323100,35190390,82513490
"Sep 30, 1994",1994,The River Wild,45000000,46815000,47400000,94215000
"May 23, 2014",2014,Blended,45000000,46290741,81700000,127990741
"Jun 16, 2017",2017,All Eyez on Me,45000000,44922302,9954553,54876855
"Jan 13, 2006",2006,Last Holiday,45000000,38399961,4943286,43343247
"Mar 3, 2006",2006,16 Blocks,45000000,36895141,28700000,65595141
"Jul 14, 1995",1995,The Indian in the Cupboard,45000000,35627222,0,35627222
"Sep 10, 2004",2004,Cellular,45000000,32003620,29472364,61475984
"Jul 28, 2006",2006,The Ant Bully,45000000,28142535,21468363,49610898
"Jul 18, 2003",2003,Johnny English,45000000,28013509,135113167,163126676
"Dec 14, 1984",1984,Dune,45000000,27447471,0,27447471
"Jul 31, 2009",2009,Aliens in the Attic,45000000,25200412,34350871,59551283
"Sep 14, 2007",2007,Across the Universe,45000000,24343673,5023470,29367143
"Dec 26, 2008",2008,Revolutionary Road,45000000,22951340,56653480,79604820
"Aug 29, 2008",2008,Babylon A.D.,45000000,22532572,47683925,70216497
"Nov 4, 1994",1994,Frankenstein,45000000,22006296,90000000,112006296
"Oct 4, 1996",1996,The Glimmer Man,45000000,20404841,16000000,36404841
"Jul 17, 1996",1996,Multiplicity,45000000,20133326,0,20133326
"May 3, 2019",2019,UglyDolls,45000000,19894664,4750000,24644664
"Jan 19, 2001",2001,The Pledge,45000000,19719930,9686202,29406132
"Dec 16, 2005",2005,The Producers: The Movie Musical,45000000,19398532,13554463,32952995
"Jun 7, 1996",1996,The Phantom,45000000,17220599,0,17220599
"Jul 1, 2005",2005,Rebound,45000000,16809014,683000,17492014
"Feb 19, 2010",2010,The Ghost Writer,45000000,15541549,49990942,65532491
"Dec 22, 2000",2000,All the Pretty Horses,45000000,15527125,2593142,18120267
"Sep 5, 2008",2008,Bangkok Dangerous,45000000,15298133,31300000,46598133
"Dec 20, 1995",1995,Nixon,45000000,13668249,21000000,34668249
"Sep 21, 2012",2012,Dredd,45000000,13414714,28052892,41467606
"Oct 28, 2011",2011,The Rum Diary,45000000,13109815,8434917,21544732
"Jan 30, 1998",1998,Deep Rising,45000000,11203026,0,11203026
"Dec 21, 2018",2018,Welcome to Marwen,45000000,10763520,2111402,12874922
"Oct 21, 2011",2011,Johnny English Reborn,45000000,8406711,156233690,164640401
"Sep 26, 2008",2008,Miracle at St. Anna,45000000,7916887,1759610,9676497
"Apr 5, 2002",2002,Big Trouble,45000000,7262288,1226583,8488871
"Dec 21, 2006",2006,Man cheng jin dai huang jin jia,45000000,6566773,70337656,76904429
"Nov 16, 2007",2007,Love in the Time of Cholera,45000000,4617608,26459810,31077418
"Dec 25, 2002",2002,Pinocchio,45000000,3681811,28000000,31681811
"Jan 31, 1997",1997,Shadow Conspiracy,45000000,2154540,0,2154540
"Dec 31, 2012",2012,Foodfight!,45000000,0,73706,73706
"Oct 12, 2012",2012,Argo,44500000,136025503,91115254,227140757
"Aug 6, 1993",1993,The Fugitive,44000000,183875760,169839557,353715317
"May 22, 1985",1985,Rambo: First Blood Part II,44000000,150415432,149984568,300400000
"Oct 18, 1996",1996,Sleepers,44000000,53300852,112300000,165600852
"Jul 30, 2010",2010,Charlie St. Cloud,44000000,31206263,17271821,48478084
"Feb 2, 1996",1996,The Juror,44000000,22730924,0,22730924
"Feb 6, 2014",2014,The Interview,44000000,6105175,6237457,12342632
"Nov 19, 1980",1980,Heaven's Gate,44000000,3484331,192,3484523
"Jun 28, 2013",2013,The Heat,43000000,159581587,70146187,229727774
"Dec 19, 2000",2000,Finding Forrester,43000000,51768623,28245000,80013623
"Apr 14, 2000",2000,28 Days,43000000,37035515,25028457,62063972
"May 13, 2005",2005,Danny the Dog,43000000,24537621,24500000,49037621
"Apr 12, 2002",2002,The Sweetest Thing,43000000,24430272,38648484,63078756
"Nov 9, 2018",2018,The Girl in the Spiderâs Web,43000000,14828555,20154787,34983342
"Jan 6, 2017",2017,A Monster Calls,43000000,3740823,42673707,46414530
"Jan 28, 2011",2011,The Mechanic,42500000,29121498,47225895,76347393
"Jun 30, 1993",1993,The Firm,42000000,158340892,112000000,270340892
"Mar 16, 2012",2012,21 Jump Street,42000000,138447667,64364762,202812429
"May 28, 1999",1999,Notting Hill,42000000,116089678,247638407,363728085
"Jun 21, 2000",2000,Chicken Run,42000000,106793915,121000000,227793915
"Jan 16, 2004",2004,Along Came Polly,42000000,88073507,84970903,173044410
"Jul 1, 1992",1992,Boomerang,42000000,70052444,61000000,131052444
"Jul 10, 2009",2009,BrÃ¼no,42000000,60054530,78653997,138708527
"Jun 12, 1963",1963,Cleopatra,42000000,57000000,14000000,71000000
"May 12, 2017",2017,Snatched,42000000,45852178,11999999,57852177
"Oct 12, 2012",2012,Here Comes the Boom,42000000,45290318,27948940,73239258
"Apr 5, 2002",2002,High Crimes,42000000,41543207,22237893,63781100
"Nov 15, 1996",1996,The Mirror Has Two Faces,42000000,41267469,0,41267469
"Mar 11, 2011",2011,Red Riding Hood,42000000,37662162,54016280,91678442
"Jan 25, 2002",2002,The Mothman Prophecies,42000000,35228696,21209859,56438555
"Jul 14, 1989",1989,Licence to Kill,42000000,34667015,121500000,156167015
"Dec 25, 2018",2018,Holmes & Watson,42000000,30568743,11357862,41926605
"Jan 27, 2012",2012,One for the Money,42000000,26414527,9782694,36197221
"Mar 9, 2001",2001,15 Minutes,42000000,24375436,31956428,56331864
"Sep 16, 2005",2005,Lord of War,42000000,24149632,36288095,60437727
"May 28, 1993",1993,Super Mario Bros.,42000000,20844907,0,20844907
"Oct 2, 1992",1992,Hero,42000000,19487173,47300000,66787173
"Jan 27, 2012",2012,Man on a Ledge,42000000,18620000,31001440,49621440
"Dec 3, 2010",2010,The Warrior's Way,42000000,5666340,2847985,8514325
"Apr 18, 1997",1997,McHale's Navy,42000000,4408420,0,4408420
"May 28, 2010",2010,Micmacs,42000000,1259693,10497229,11756922
"Dec 31, 2006",2006,Les BronzÃ©s 3: amis pour la vie,42000000,0,83833602,83833602
"Dec 31, 2015",2015,Pourquoi j'ai pas mangÃ© mon pÃ¨re,42000000,0,15451663,15451663
"Nov 8, 2002",2002,8 Mile,41000000,116724075,129044309,245768384
"May 31, 2019",2019,Rocketman,41000000,57342725,51300000,108642725
"May 11, 2001",2001,A Knightâs Tale,41000000,56083966,44538620,100622586
"Aug 22, 2003",2003,The Medallion,41000000,22108977,0,22108977
"Oct 14, 2011",2011,The Big Year,41000000,7204138,480386,7684524
"Aug 6, 1999",1999,The Sixth Sense,40000000,293506292,379300000,672806292
"Jul 15, 2005",2005,Wedding Crashers,40000000,209218368,74000000,283218368
"Jun 11, 2010",2010,The Karate Kid,40000000,176591618,175183320,351774938
"Feb 13, 2015",2015,Fifty Shades of Grey,40000000,166167230,404830871,570998101
"Jun 19, 2009",2009,The Proposal,40000000,163958031,150751686,314709717
"Dec 13, 2013",2013,American Hustle,40000000,150117807,107760487,257878294
"May 17, 2019",2019,John Wick: Chapter 3 â Parabellum,40000000,141744320,114753713,256498033
"Dec 25, 2003",2003,Cheaper by the Dozen,40000000,138614544,51597569,190212113
"Jul 25, 2014",2014,Lucy,40000000,126573960,330933816,457507776
"Dec 25, 2013",2013,Lone Survivor,40000000,125095601,24709031,149804632
"Nov 22, 1989",1989,Back to the Future Part II,40000000,118450002,213549998,332000000
"Sep 24, 1999",1999,Double Jeopardy,40000000,116735231,61100000,177835231
"Jul 25, 2003",2003,Spy Kids 3-D: Game Over,40000000,111760631,56091364,167851995
"Jul 24, 1996",1996,A Time to Kill,40000000,108766007,43500000,152266007
"Jul 1, 1992",1992,A League of Their Own,40000000,107533925,24906141,132440066
"Jun 10, 2016",2016,The Conjuring 2: The Enfield Poltergeist,40000000,102470008,208792094,311262102
"Oct 1, 2010",2010,The Social Network,40000000,96962694,127959441,224922135
"Aug 7, 2009",2009,Julie & Julia,40000000,94125426,32520693,126646119
"Feb 6, 2009",2009,He's Just Not That Into You,40000000,93953653,87100004,181053657
"Feb 10, 2017",2017,John Wick: Chapter Two,40000000,92029184,79320825,171350009
"Jan 15, 2016",2016,Ride Along 2,40000000,90862685,33964631,124827316
"Apr 14, 2006",2006,Scary Movie 4,40000000,90710620,88000000,178710620
"Mar 27, 2015",2015,Get Hard,40000000,90411453,16100000,106511453
"Feb 4, 2000",2000,Scream 3,40000000,89138076,72700000,161838076
"May 24, 1990",1990,Back to the Future Part III,40000000,88055283,156033371,244088654
"Oct 14, 2016",2016,The Accountant,40000000,86260045,66702038,152962083
"Nov 14, 2014",2014,Dumb and Dumber To,40000000,86208010,70345582,156553592
"Apr 25, 2014",2014,The Other Woman,40000000,83911193,111200000,195111193
"Nov 13, 1992",1992,Bram Stoker's Dracula,40000000,82522790,133339902,215862692
"Feb 17, 2006",2006,Eight Below,40000000,81612565,38843429,120455994
"Dec 24, 1999",1999,The Talented Mr. Ripley,40000000,81292135,47500000,128792135
"Sep 25, 2015",2015,The Intern,40000000,75764672,121351038,197115710
"Sep 25, 1992",1992,The Last of the Mohicans,40000000,75505856,0,75505856
"Oct 29, 2004",2004,Ray,40000000,75305995,49517099,124823094
"Apr 1, 2005",2005,Sin City,40000000,74103820,84424098,158527918
"Oct 16, 2015",2015,Bridge of Spies,40000000,72313754,90184584,162498338
"Feb 22, 2008",2008,Vantage Point,40000000,72266306,78620023,150886329
"Mar 20, 2009",2009,"I Love You, Man",40000000,72013010,20289492,92302502
"Nov 9, 2001",2001,Shallow Hal,40000000,70836296,0,70836296
"Dec 20, 1991",1991,JFK,40000000,70405498,134994502,205400000
"Jan 27, 2006",2006,Big Momma's House 2,40000000,70165972,66881404,137047376
"Sep 21, 2018",2018,The House with a Clock in its Walls,40000000,68549695,57782055,126331750
"Nov 4, 2016",2016,Hacksaw Ridge,40000000,67209615,101695067,168904682
"Mar 2, 2001",2001,The Mexican,40000000,66808615,78429635,145238250
"Aug 28, 2009",2009,The Final Destination,40000000,66477700,120906927,187384627
"Apr 17, 2009",2009,17 Again,40000000,64167069,75307837,139474906
"Feb 18, 2011",2011,Unknown,40000000,63686397,72436686,136123083
"Jun 4, 2010",2010,Get Him to the Greek,40000000,61153526,30302349,91455875
"Nov 21, 2003",2003,Gothika,40000000,59588068,81896744,141484812
"Nov 30, 2001",2001,Behind Enemy Lines,40000000,58855732,0,58855732
"Mar 18, 2011",2011,The Lincoln Lawyer,40000000,58009200,29135886,87145086
"Oct 15, 2004",2004,Shall We Dance?,40000000,57887882,60210000,118097882
"Aug 25, 2006",2006,Invincible,40000000,57806952,694175,58501127
"Feb 15, 2013",2013,Escape From Planet Earth,40000000,57012977,17143633,74156610
"Jul 10, 1998",1998,Small Soldiers,40000000,55143823,16600000,71743823
"Jul 31, 1997",1997,Spawn,40000000,54979992,32969867,87949859
"Nov 26, 2014",2014,Horrible Bosses 2,40000000,54445357,51500000,105945357
"Jan 25, 2002",2002,The Count of Monte Cristo,40000000,54228104,21160986,75389090
"Oct 20, 2006",2006,The Prestige,40000000,53089891,51317475,104407366
"Jun 16, 2006",2006,The Lake House,40000000,52330111,62500000,114830111
"Jul 9, 2010",2010,Predators,40000000,52000688,75233701,127234389
"Aug 15, 2012",2012,The Odd Life of Timothy Green,40000000,51853450,3395709,55249159
"Jul 31, 1987",1987,The Living Daylights,40000000,51185000,140015000,191200000
"Dec 8, 2006",2006,Apocalypto,40000000,50866635,70165637,121032272
"Feb 14, 2007",2007,Music and Lyrics,40000000,50572589,95624296,146196885
"Jun 18, 1986",1986,Legal Eagles,40000000,49851591,0,49851591
"Mar 12, 2004",2004,Secret Window,40000000,47958031,44153520,92111551
"Aug 12, 2005",2005,The Skeleton Key,40000000,47907715,44349203,92256918
"Jun 20, 2014",2014,Jersey Boys,40000000,47047013,18235719,65282732
"May 2, 2008",2008,Made of Honor,40000000,46012734,60536004,106548738
"Nov 21, 1997",1997,The Rainmaker,40000000,45916769,0,45916769
"Feb 7, 1992",1992,Medicine Man,40000000,44948240,0,44948240
"Dec 12, 1997",1997,Amistad,40000000,44212592,14037559,58250151
"May 30, 2014",2014,A Million Ways to Die in The West,40000000,42720965,44057592,86778557
"Aug 12, 2011",2011,Final Destination 5,40000000,42587643,112423522,155011165
"Nov 16, 2018",2018,Widows,40000000,42402632,31463456,73866088
"Apr 8, 2005",2005,Fever Pitch,40000000,42071069,8000000,50071069
"Dec 25, 2007",2007,Aliens vs. Predator - Requiem,40000000,41797066,87087428,128884494
"Dec 25, 2007",2007,The Water Horse: Legend of the Deep,40000000,40412817,63016938,103429755
"Jul 18, 2014",2014,Sex Tape,40000000,38543473,87526036,126069509
"Apr 15, 2011",2011,Scream 4,40000000,38180928,57808662,95989590
"Dec 21, 1994",1994,Ri¢hie Ri¢h,40000000,38087756,0,38087756
"Aug 11, 2000",2000,Autumn in New York,40000000,37752931,52964753,90717684
"Mar 18, 2011",2011,Paul,40000000,37412945,63749161,101162106
"Dec 19, 2012",2012,The Guilt Trip,40000000,37134215,4160459,41294674
"Aug 26, 2011",2011,Colombiana,40000000,36665854,35629408,72295262
"Feb 26, 1999",1999,8MM,40000000,36443442,59955384,96398826
"Jan 12, 2018",2018,The Commuter,40000000,36343858,65641573,101985431
"Feb 18, 2000",2000,Hanging Up,40000000,36037909,15829814,51867723
"Mar 1, 1991",1991,The Doors,40000000,34416893,0,34416893
"Aug 20, 1999",1999,Mickey Blue Eyes,40000000,33864342,20000000,53864342
"Oct 20, 2000",2000,Pay it Forward,40000000,33508922,22187783,55696705
"Apr 8, 2011",2011,Arthur,40000000,33035397,14752546,47787943
"Mar 21, 2008",2008,Drillbit Taylor,40000000,32862104,16824159,49686263
"Dec 21, 2016",2016,Patriots Day,40000000,31886361,20951628,52837989
"Dec 25, 2011",2011,Extremely Loud and Incredibly Close,40000000,31847881,23400000,55247881
"Jul 1, 1994",1994,The Shadow,40000000,31835600,0,31835600
"Nov 26, 2008",2008,Transporter 3,40000000,31715062,75520530,107235592
"Nov 10, 2010",2010,Morning Glory,40000000,31011732,28783338,59795070
"Nov 9, 2005",2005,Get Rich or Die Tryin',40000000,30981850,15685105,46666955
"May 3, 2019",2019,Long Shot,40000000,30202860,13508171,43711031
"Aug 25, 2000",2000,The Art of War,40000000,30199105,0,30199105
"Dec 25, 2013",2013,Grudge Match,40000000,29807260,40000000,69807260
"Aug 11, 2000",2000,Bless the Child,40000000,29374178,11061516,40435694
"Nov 23, 2005",2005,Rent,40000000,29077547,2593073,31670620
"Apr 2, 1999",1999,The Out-of-Towners,40000000,28544120,0,28544120
"Aug 11, 2017",2017,The Nut Job 2: Nutty by Nature,40000000,28370522,29067867,57438389
"Aug 23, 1996",1996,The Island of Dr. Moreau,40000000,27682712,0,27682712
"Sep 7, 2001",2001,The Musketeer,40000000,27053815,0,27053815
"Jan 27, 2017",2017,Resident Evil: The Final Chapter,40000000,26844692,287256498,314101190
"Feb 29, 2008",2008,The Other Boleyn Girl,40000000,26814957,51455013,78269970
"Jun 30, 2017",2017,The House,40000000,25584504,5607921,31192425
"Feb 16, 2001",2001,Sweet November,40000000,25288103,40466125,65754228
"Apr 5, 2007",2007,The Reaping,40000000,25126214,37100000,62226214
"Jan 7, 2011",2011,Season of the Witch,40000000,24827228,66299372,91126600
"Jun 3, 1994",1994,Renaissance Man,40000000,24172899,0,24172899
"May 15, 1998",1998,Quest for Camelot,40000000,22772500,15400000,38172500
"Sep 6, 2002",2002,City by the Sea,40000000,22433915,0,22433915
"Jan 15, 1999",1999,At First Sight,40000000,22365133,0,22365133
"Aug 26, 2016",2016,Mechanic: Resurrection,40000000,21218403,88520437,109738840
"Jan 16, 2004",2004,Torque,40000000,21176322,25000000,46176322
"Nov 13, 2009",2009,Fantastic Mr. Fox,40000000,21002919,26080493,47083412
"Sep 22, 1995",1995,Showgirls,40000000,20350754,17400000,37750754
"Feb 16, 1996",1996,City Hall,40000000,20278055,0,20278055
"Feb 3, 2012",2012,Big Miracle,40000000,20157300,5111380,25268680
"Dec 21, 2012",2012,The Impossible,40000000,19019882,150570724,169590606
"Mar 9, 2012",2012,A Thousand Words,40000000,18450127,2340359,20790486
"Oct 20, 2006",2006,Marie Antoinette,40000000,15962471,44900000,60862471
"Oct 6, 2000",2000,Get Carter,40000000,14967182,4450000,19417182
"Apr 21, 1995",1995,Kiss of Death,40000000,14942422,0,14942422
"Apr 26, 2002",2002,"Life, or Something Like It",40000000,14448589,0,14448589
"May 15, 1987",1987,Ishtar,40000000,14375181,0,14375181
"Feb 28, 1992",1992,Memoirs of an Invisible Man,40000000,14358033,0,14358033
"Oct 23, 2009",2009,Amelia,40000000,14279575,5476502,19756077
"Oct 23, 2009",2009,Cirque du Freak: The Vampire's Assistant,40000000,14046595,25707362,39753957
"May 7, 2004",2004,New York Minute,40000000,14018364,7197518,21215882
"Mar 12, 1999",1999,The Deep End of the Ocean,40000000,13508635,0,13508635
"Nov 5, 2004",2004,Alfie,40000000,13395939,21800000,35195939
"Aug 30, 2002",2002,FearDotCom,40000000,13208023,0,13208023
"Nov 7, 2008",2008,Soul Men,40000000,12082391,263492,12345883
"Mar 20, 2015",2015,The Gunman,40000000,10664749,7929478,18594227
"Aug 20, 1999",1999,Universal Soldier II: The Return,40000000,10447421,270000,10717421
"Sep 25, 2009",2009,Pandorum,40000000,10330853,6702578,17033431
"Sep 26, 2003",2003,Duplex,40000000,9652000,418651,10070651
"Aug 16, 2013",2013,Paranoia,40000000,7388654,8952113,16340767
"Aug 1, 1980",1980,Raise the Titanic,40000000,7000000,0,7000000
"Jul 10, 2015",2015,Baahubali: The Beginning,40000000,6738000,19998665,26736665
"Mar 9, 2018",2018,The Hurricane Heist,40000000,6115824,24847860,30963684
"Jan 4, 2002",2002,Impostor,40000000,6114237,1860370,7974607
"Nov 25, 2015",2015,Victor Frankenstein,40000000,5775076,25349291,31124367
"Nov 27, 2002",2002,Extreme Ops,40000000,4835968,7788503,12624471
"Apr 6, 2001",2001,Just Visiting,40000000,4777007,11395193,16172200
"Jun 27, 2014",2014,Snowpiercer,40000000,4563029,83506851,88069880
"Jul 20, 2007",2007,Sunshine,40000000,3688560,28342050,32030610
"Mar 11, 1994",1994,The Hudsucker Proxy,40000000,2816518,12121631,14938149
"Nov 11, 2016",2016,Billy Lynnâs Long Halftime Walk,40000000,1738477,28491925,30230402
"Jul 1, 1986",1986,Pirates,40000000,1641825,4700000,6341825
"Dec 12, 2008",2008,Delgo,40000000,915840,0,915840
"Sep 7, 2007",2007,The Hunting Party,40000000,876671,6852881,7729552
"Oct 13, 2006",2006,Alex Rider: Operation Stormbreaker,40000000,659210,20063240,20722450
"Nov 20, 2009",2009,Red Cliff,40000000,627047,119000000,119627047
"Sep 24, 2004",2004,The Last Shot,40000000,463730,0,463730
"Mar 16, 2007",2007,Nomad,40000000,79123,0,79123
"Apr 16, 2013",2013,Un monstre Ã Paris,40000000,0,27000381,27000381
"Jun 21, 2019",2019,Kursk,40000000,0,4212799,4212799
"Nov 11, 2016",2016,USS Indianapolis: Men of Courage,40000000,0,1663785,1663785
"Dec 31, 2014",2014,Dragon Nest Warriors' Dawn,40000000,0,734423,734423
"Dec 31, 2018",2018,The Crow,40000000,0,0,0
"Sep 13, 2019",2019,The Goldfinch,40000000,0,0,0
"Dec 31, 2019",2019,Down Under Cover,40000000,0,0,0
"Aug 14, 2009",2009,The Time Traveler's Wife,39000000,63414846,38917289,102332135
"Jun 17, 1983",1983,Superman III,39000000,59950623,0,59950623
"Feb 2, 2007",2007,Because I Said So,39000000,42674040,26864793,69538833
"Oct 5, 2012",2012,Frankenweenie,39000000,35287788,45863000,81150788
"Mar 29, 1996",1996,Sgt. Bilko,39000000,30356589,7600000,37956589
"Sep 30, 2005",2005,Serenity,39000000,25514517,14804923,40319440
"Sep 7, 2007",2007,Shoot 'Em Up,39000000,12796824,14000000,26796824
"Feb 20, 2004",2004,Against the Ropes,39000000,5881504,548361,6429865
"Aug 23, 2013",2013,Yi dai zong shi,38600000,6594959,51392340,57987299
"Jun 22, 2001",2001,The Fast and the Furious,38000000,144512310,62000000,206512310
"Sep 27, 2002",2002,Sweet Home Alabama,38000000,127214072,55151042,182365114
"Jul 24, 2009",2009,The Ugly Truth,38000000,88915214,116383693,205298907
"Aug 7, 2002",2002,Spy Kids 2: The Island of Lost Dreams,38000000,85846296,33875000,119721296
"Nov 18, 1994",1994,Star Trek: Generations,38000000,75671262,44328738,120000000
"Jun 2, 2017",2017,Captain Underpants: The First Epic Movie,38000000,73921000,52656874,126577874
"Apr 17, 2015",2015,Paul Blart: Mall Cop 2,38000000,71091594,36559052,107650646
"Dec 19, 1997",1997,Mouse Hunt,38000000,61894591,0,61894591
"Dec 23, 2016",2016,Why Him?,38000000,60323786,57101370,117425156
"Apr 22, 2011",2011,Water for Elephants,38000000,58709717,58100000,116809717
"Oct 8, 2010",2010,Life as We Know It,38000000,53374681,52513156,105887837
"Dec 29, 1999",1999,The Hurricane,38000000,50699241,23257000,73956241
"Sep 6, 2013",2013,Riddick,38000000,42025135,52738623,94763758
"Mar 23, 2001",2001,Heartbreakers,38000000,40334024,17419801,57753825
"May 24, 2002",2002,Enough,38000000,39177215,11793445,50970660
"Jan 22, 2016",2016,The 5th Wave,38000000,34912982,76423416,111336398
"Feb 6, 2009",2009,Push,38000000,31811527,17866874,49678401
"Sep 20, 2013",2013,Rush,38000000,26947624,71283215,98230839
"May 18, 2001",2001,Angel Eyes,38000000,24044532,5500000,29544532
"Dec 21, 2001",2001,Joe Somebody,38000000,22770864,1745126,24515990
"Mar 10, 2000",2000,The Ninth Gate,38000000,18653746,39740562,58394308
"Oct 20, 2017",2017,Only the Brave,38000000,18340051,6215126,24555177
"Sep 27, 1996",1996,Extreme Measures,38000000,17378193,0,17378193
"Oct 14, 2011",2011,The Thing,38000000,16999934,10573144,27573078
"Sep 7, 2001",2001,Rock Star,38000000,16991902,2325863,19317765
"Feb 2, 1996",1996,White Squall,38000000,10229300,0,10229300
"Oct 10, 2008",2008,City of Ember,38000000,7873007,9958551,17831558
"Oct 31, 1997",1997,Switchback,38000000,6504442,0,6504442
"Sep 21, 2018",2018,The Sisters Brothers,38000000,3143056,10000000,13143056
"Nov 30, 2001",2001,Texas Rangers,38000000,623374,0,623374
"Aug 26, 2008",2008,Virgin Territory,38000000,0,5473041,5473041
"Jan 11, 2019",2019,The Upside,37500000,108235497,10789039,119024536
"May 18, 2012",2012,What to Expect When You're Expecting,37500000,41152203,47320813,88473016
"Sep 14, 2012",2012,The Master,37500000,16247159,34400257,50647416
"Oct 10, 2008",2008,The Express,37500000,9793406,19903,9813309
"Nov 21, 2008",2008,Twilight,37000000,192769854,209510305,402280159
"Aug 7, 2013",2013,We're the Millers,37000000,150394119,117422157,267816276
"Nov 25, 2015",2015,Creed,37000000,109767581,63800000,173567581
"Sep 17, 2010",2010,The Town,37000000,92186262,60380619,152566881
"Sep 23, 2011",2011,Dolphin Tale,37000000,72286779,23781945,96068724
"Feb 23, 2018",2018,Game Night,37000000,69179066,48199018,117378084
"Sep 12, 2008",2008,Burn After Reading,37000000,60355347,107812451,168167798
"Apr 23, 2004",2004,13 Going On 30,37000000,57139723,40518989,97658712
"Apr 4, 2008",2008,Nim's Island,37000000,48006762,53850663,101857425
"Feb 12, 2016",2016,How to be Single,37000000,46843513,53160267,100003780
"Feb 26, 2010",2010,Cop Out,37000000,44875481,11034429,55909910
"Jan 28, 2011",2011,The Rite,37000000,33047633,64096354,97143987
"Jul 18, 2008",2008,Space Chimps,37000000,30105968,36923988,67029956
"Dec 17, 1999",1999,Magnolia,37000000,22450975,25995827,48446802
"May 29, 2015",2015,Aloha,37000000,21052030,4335061,25387091
"Dec 31, 2009",2009,Obitaemyy ostrov,36500000,0,15000000,15000000
"Oct 5, 2018",2018,A Star is Born,36000000,215288866,218160705,433449571
"Feb 11, 2011",2011,Gnomeo and Juliet,36000000,99967670,93770307,193737977
"Feb 15, 2002",2002,John Q,36000000,71026631,31200000,102226631
"Sep 17, 1999",1999,Blue Streak,36000000,68208190,49239967,117448157
"Oct 7, 1983",1983,Never Say Never Again,36000000,55500000,104500000,160000000
"Mar 26, 2010",2010,Hot Tub Time Machine,36000000,50269859,15697891,65967750
"May 2, 1997",1997,Breakdown,36000000,50159144,0,50159144
"Sep 12, 2014",2014,Dolphin Tale 2,36000000,42024533,15800000,57824533
"Dec 16, 2016",2016,Collateral Beauty,36000000,31016021,54293072,85309093
"Apr 4, 2003",2003,A Man Apart,36000000,26500000,17297731,43797731
"Feb 25, 2000",2000,Reindeer Games,36000000,23360779,0,23360779
"Dec 24, 1999",1999,Snow Falling on Cedars,36000000,14378353,0,14378353
"Dec 20, 1996",1996,Ghosts of Mississippi,36000000,13052741,0,13052741
"Oct 24, 1997",1997,Gattaca,36000000,12532777,0,12532777
"Jan 28, 2000",2000,Isn't She Great,36000000,2954405,0,2954405
"Jan 22, 2016",2016,Yip Man 3,36000000,2679437,154621517,157300954
"May 6, 2011",2011,There Be Dragons,36000000,1069334,2951656,4020990
"Apr 14, 2017",2017,Queen of the Desert,36000000,0,1578543,1578543
"Mar 28, 2003",2003,Head of State,35200000,37788228,495537,38283765
"Sep 8, 2017",2017,It,35000000,327481748,369976221,697457969
"Jun 5, 2009",2009,The Hangover,35000000,277322503,188441583,465764086
"Nov 20, 2009",2009,The Blind Side,35000000,255959475,49746319,305705794
"Jun 23, 1989",1989,Batman,35000000,251188924,160160000,411348924
"Jun 10, 1999",1999,Austin Powers: The Spy Who Shagged Me,35000000,206040085,106343402,312383487
"Dec 22, 2010",2010,True Grit,35000000,171243005,81033923,252276928
"May 15, 1992",1992,Lethal Weapon 3,35000000,144731527,174968473,319700000
"Sep 18, 1998",1998,Rush Hour,35000000,141186864,104113136,245300000
"Feb 8, 2013",2013,Identity Thief,35000000,134506920,40854658,175361578
"Jun 30, 2006",2006,The Devil Wears Prada,35000000,124740460,201332695,326073155
"Jul 8, 2011",2011,Horrible Bosses,35000000,117538559,94879042,212417601
"Mar 30, 2001",2001,Spy Kids,35000000,112692062,85000000,197692062
"Jul 17, 2015",2015,Trainwreck,35000000,110212700,30911197,141123897
"Dec 13, 2013",2013,Saving Mr. Banks,35000000,83299761,31662764,114962525
"Dec 7, 1979",1979,Star Trek: The Motion Picture,35000000,82258456,56741544,139000000
"Mar 28, 2008",2008,21,35000000,81159365,78687064,159846429
"May 9, 2008",2008,What Happens in Vegas...,35000000,80277646,138258062,218535708
"Nov 15, 1991",1991,Cape Fear,35000000,79091969,103200000,182291969
"Nov 15, 1996",1996,The English Patient,35000000,78716374,152993634,231710008
"Jan 16, 2009",2009,Hotel for Dogs,35000000,73178547,49178625,122357172
"Mar 25, 2005",2005,Guess Who,35000000,68915888,33200000,102115888
"Dec 21, 2012",2012,This is 40,35000000,67544505,22676677,90221182
"Sep 19, 1997",1997,L.A. Confidential,35000000,64604977,61600000,126204977
"Jul 29, 2005",2005,Sky High,35000000,63939454,19169905,83109359
"Sep 19, 1997",1997,In & Out,35000000,63826569,19400000,83226569
"Apr 30, 2010",2010,A Nightmare on Elm Street,35000000,63075011,54654610,117729621
"Aug 18, 2000",2000,The Cell,35000000,61280963,24630263,85911226
"Jul 7, 1995",1995,Species,35000000,60054449,53300000,113354449
"Apr 7, 2006",2006,The Benchwarmers,35000000,59843754,5219972,65063726
"Oct 8, 2010",2010,Secretariat,35000000,59699513,676734,60376247
"Mar 13, 1998",1998,The Man in the Iron Mask,35000000,56968169,0,56968169
"Jul 22, 2011",2011,Friends with Benefits,35000000,55802754,90793137,146595891
"May 20, 2016",2016,Neighbors 2: Sorority Rising,35000000,55340730,53416891,108757621
"Mar 23, 2007",2007,TMNT,35000000,54149098,41946920,96096018
"Oct 24, 2003",2003,Radio,35000000,52333738,959890,53293628
"Jun 29, 2018",2018,Sicario: Day of the Soldado,35000000,50065850,25819346,75885196
"Nov 25, 2009",2009,Old Dogs,35000000,49492060,45612244,95104304
"Nov 18, 1992",1992,Malcolm X,35000000,48169910,0,48169910
"May 22, 2015",2015,Poltergeist,35000000,47425125,48287944,95713069
"Oct 12, 2018",2018,Goosebumps 2: Haunted Halloween,35000000,46697321,46594157,93291478
"Jan 19, 2018",2018,12 Strong,35000000,45819713,25298665,71118378
"Jan 23, 2009",2009,Underworld 3: Rise of the Lycans,35000000,45802315,43300000,89102315
"Jul 29, 2005",2005,Must Love Dogs,35000000,43894863,14510450,58405313
"Jul 3, 2007",2007,License to Wed,35000000,43799818,26387270,70187088
"Feb 28, 1997",1997,Donnie Brasco,35000000,41954997,23348055,65303052
"Oct 17, 2008",2008,Max Payne,35000000,40689393,47085657,87775050
"Mar 15, 2002",2002,Resident Evil,35000000,40119709,63667692,103787401
"Mar 26, 2004",2004,The Ladykillers,35000000,39692139,37700000,77392139
"May 6, 2011",2011,Something Borrowed,35000000,39046489,26037627,65084116
"Dec 1, 2006",2006,The Nativity Story,35000000,37629831,8679813,46309644
"Oct 28, 2011",2011,In Time,35000000,37553932,127550020,165103952
"Apr 23, 2010",2010,The Back-up Plan,35000000,37490007,37791172,75281179
"Nov 9, 2011",2011,J. Edgar,35000000,37306030,47300000,84606030
"Nov 17, 2000",2000,Bounce,35000000,36805288,16620004,53425292
"Aug 17, 2018",2018,Mile 22,35000000,36108758,30186363,66295121
"May 8, 2015",2015,Hot Pursuit,35000000,34580201,11091311,45671512
"Dec 25, 2015",2015,Concussion,35000000,34531832,15831958,50363790
"Oct 13, 2017",2017,The Foreigner,35000000,34393507,106389853,140783360
"Dec 3, 2004",2004,Closer,35000000,33987757,82189938,116177695
"Dec 23, 1994",1994,Street Fighter,35000000,33423000,66000000,99423000
"Nov 21, 2001",2001,Black Knight,35000000,33422806,0,33422806
"Jul 22, 2005",2005,The Bad News Bears,35000000,32868349,632271,33500620
"Dec 27, 2002",2002,The Pianist,35000000,32519322,79334860,111854182
"May 6, 2005",2005,House of Wax,35000000,32064800,38000000,70064800
"Oct 19, 2001",2001,From Hell,35000000,31598308,37114057,68712365
"Jun 1, 2018",2018,Adrift,35000000,31445011,26452180,57897191
"Aug 15, 2008",2008,Mirrors,35000000,30691439,46529157,77220596
"Jan 6, 2017",2017,Underworld: Blood Wars,35000000,30353973,50855249,81209222
"Feb 22, 2002",2002,Queen of the Damned,35000000,30307804,0,30307804
"Aug 20, 2010",2010,Nanny McPhee and the Big Bang,35000000,29197642,68602223,97799865
"Jan 25, 2008",2008,Untraceable,35000000,28687835,23962116,52649951
"Nov 21, 1990",1990,Predator 2,35000000,28317513,26450905,54768418
"Sep 23, 2011",2011,Abduction,35000000,28087155,58561204,86648359
"Dec 5, 1980",1980,Flash Gordon,35000000,27107960,0,27107960
"Mar 28, 2008",2008,Superhero Movie,35000000,26638520,46387782,73026302
"Feb 12, 1999",1999,Blast from the Past,35000000,26613620,0,26613620
"Oct 19, 2012",2012,Alex Cross,35000000,25888412,9538347,35426759
"Mar 26, 2004",2004,Jersey Girl,35000000,25266129,11800000,37066129
"Nov 21, 1997",1997,Midnight in the Garden of Good and Evil,35000000,25078937,0,25078937
"Sep 16, 2016",2016,Bridget Jonesâs Baby,35000000,24139805,181682883,205822688
"Nov 9, 2001",2001,Heist,35000000,23483357,5423460,28906817
"Dec 25, 1992",1992,Hoffa,35000000,23365858,5025615,28391473
"Mar 4, 2016",2016,Whiskey Tango Foxtrot,35000000,23083334,2267413,25350747
"Apr 9, 2004",2004,Ella Enchanted,35000000,22913677,0,22913677
"Aug 21, 2015",2015,Hitman: Agent 47,35000000,22467450,59715353,82182803
"Jul 25, 2008",2008,The X-Files: I Want to Believe,35000000,20982478,47188314,68170792
"Aug 24, 2012",2012,Premium Rush,35000000,20275446,11117755,31393201
"Jan 18, 2013",2013,Broken City,35000000,19701164,14778881,34480045
"Aug 19, 2005",2005,Valiant,35000000,19478106,44710281,64188387
"Feb 23, 2000",2000,Wonder Boys,35000000,19389454,14033031,33422485
"Feb 25, 2005",2005,Cursed,35000000,19294901,5820000,25114901
"Dec 21, 2007",2007,Walk Hard: The Dewey Cox Story,35000000,18317151,2288902,20606053
"Sep 20, 2002",2002,The Four Feathers,35000000,18306166,11576479,29882645
"Apr 30, 2010",2010,Furry Vengeance,35000000,17630465,21709712,39340177
"Jan 25, 2013",2013,Parker,35000000,17616641,30926747,48543388
"Sep 17, 2004",2004,Wimbledon,35000000,16862585,24803891,41666476
"Sep 15, 2000",2000,Bait,35000000,15325127,146842,15471969
"Dec 8, 2000",2000,Dungeons and Dragons,35000000,15185241,18586724,33771965
"Nov 9, 2007",2007,Lions for Lambs,35000000,14998070,48213018,63211088
"Jan 18, 1991",1991,Flight of the Intruder,35000000,14471440,0,14471440
"May 27, 2011",2011,The Tree of Life,35000000,13305665,48416161,61721826
"Aug 17, 2001",2001,American Outlaws,35000000,13264986,336123,13601109
"Aug 11, 2006",2006,Zoom,35000000,11989328,516860,12506188
"Dec 25, 2001",2001,The Shipping News,35000000,11405825,13000000,24405825
"Dec 18, 2009",2009,The Young Victoria,35000000,11001272,20877619,31878891
"Mar 28, 2014",2014,Sabotage,35000000,10508518,7867925,18376443
"Sep 4, 1998",1998,Knock Off,35000000,10319915,0,10319915
"Sep 11, 2009",2009,Whiteout,35000000,10275638,1979108,12254746
"Mar 6, 2015",2015,Unfinished Business,35000000,10219501,2994550,13214051
"Sep 30, 2015",2015,The Walk,35000000,10161183,51330921,61492104
"Nov 22, 2006",2006,The Fountain,35000000,10144010,5317628,15461638
"Nov 29, 2013",2013,Mandela: Long Walk to Freedom,35000000,8323085,21567317,29890402
"Dec 5, 2008",2008,Punisher: War Zone,35000000,8050977,2106557,10157534
"Sep 5, 2003",2003,The Order,35000000,7659747,3900000,11559747
"Nov 10, 2006",2006,A Good Year,35000000,7459300,34604805,42064105
"Mar 11, 2016",2016,The Brothers Grimsby,35000000,6864016,21856454,28720470
"Oct 20, 2017",2017,The Snowman,35000000,6670765,36555381,43226146
"Nov 6, 2002",2002,Femme Fatale,35000000,6630252,10200000,16830252
"May 2, 1997",1997,Warriors of Virtue,35000000,6448817,0,6448817
"Sep 26, 2003",2003,Luther,35000000,5781086,26935977,32717063
"Jan 28, 2011",2011,Biutiful,35000000,5101237,19586287,24687524
"Feb 21, 1992",1992,Radio Flyer,35000000,4651977,0,4651977
"Apr 16, 1993",1993,Bound by Honor,35000000,4496583,0,4496583
"Apr 22, 2016",2016,A Hologram for the King,35000000,4212494,7633516,11846010
"Feb 28, 1997",1997,Smilla's Sense of Snow,35000000,2221994,0,2221994
"Oct 3, 1986",1986,Playing for Keeps,35000000,2000000,0,2000000
"Jan 1, 1980",1980,Lion of the Desert,35000000,1500000,0,1500000
"Apr 19, 1996",1996,Le hussard sur le toit,35000000,1320043,0,1320043
"Nov 24, 1999",1999,Ride With the Devil,35000000,630779,0,630779
"Sep 14, 2012",2012,Stolen,35000000,289773,17677973,17967746
"Oct 14, 2011",2011,Trespass,35000000,16816,769716,786532
"Sep 22, 2006",2006,Bandidas,35000000,0,19282590,19282590
"Mar 13, 2015",2015,The Lovers,35000000,0,53899,53899
"Dec 31, 2008",2008,Black Water Transit,35000000,0,0,0
"Dec 25, 2011",2011,The Darkest Hour,34800000,21443494,41388221,62831715
"Jun 28, 2017",2017,Baby Driver,34000000,107825862,120278323,228104185
"Sep 19, 2014",2014,The Maze Runner,34000000,102427862,245891999,348319861
"Apr 10, 2015",2015,The Longest Ride,34000000,37446117,26356811,63802928
"Sep 17, 1993",1993,The Age of Innocence,34000000,32014993,0,32014993
"Aug 14, 2009",2009,Gake no ue no Ponyo,34000000,15090399,190222267,205312666
"Aug 3, 2018",2018,The Darkest Minds,34000000,12695691,25665737,38361428
"Sep 1, 1999",1999,Chill Factor,34000000,11263966,0,11263966
"Aug 27, 1999",1999,The Astronaut's Wife,34000000,10672566,0,10672566
"May 5, 2000",2000,I Dreamed of Africa,34000000,6543194,7748805,14291999
"Sep 5, 2014",2014,Thunder and the House of Magic,34000000,4091,62578429,62582520
"Dec 4, 1981",1981,Reds,33500000,50000000,0,50000000
"Dec 11, 1992",1992,A Few Good Men,33000000,141340178,95159822,236500000
"Jun 2, 2000",2000,Big Momma's House,33000000,117559438,56000000,173559438
"Mar 16, 2001",2001,Exit Wounds,33000000,51758599,28200000,79958599
"Jul 8, 2016",2016,Mike and Dave Need Wedding Dates,33000000,46009673,29888427,75898100
"Jul 27, 2012",2012,Step Up Revolution,33000000,35074677,130477613,165552290
"Aug 18, 2006",2006,Snakes on a Plane,33000000,34020814,28000000,62020814
"Apr 16, 2004",2004,The Punisher,33000000,33664370,20869404,54533774
"Sep 8, 2000",2000,The Watcher,33000000,28946615,18321214,47267829
"Apr 27, 2012",2012,Safe,33000000,17142080,24353133,41495213
"Mar 14, 2008",2008,Doomsday,33000000,11008770,10612418,21621188
"Apr 23, 1999",1999,Pushing Tin,33000000,8408835,0,8408835
"May 12, 2006",2006,Goal! The Dream Begins,33000000,4283255,23327618,27610873
"Jul 31, 2015",2015,The Young and Prodigious T.S. Spivet,33000000,176847,180840,357687
"Oct 30, 2015",2015,Freaks of Nature,33000000,70958,0,70958
"May 25, 1983",1983,Star Wars Ep. VI: Return of the Jedi,32500000,309205079,263500000,572705079
"May 13, 2011",2011,Bridesmaids,32500000,169211718,120420305,289632023
"Dec 10, 2008",2008,The Reader,32500000,34194407,78770468,112964875
"Apr 26, 2013",2013,The Big Wedding,32500000,21819348,26606623,48425971
"Feb 24, 2012",2012,Wanderlust,32500000,17288155,6871779,24159934
"Nov 7, 2003",2003,Elf,32000000,173840591,46837892,220678483
"Jul 5, 1996",1996,Phenomenon,32000000,104636382,47400000,152036382
"Jun 12, 2013",2013,This is the End,32000000,101470202,25068915,126539117
"Jan 18, 2002",2002,Snow Dogs,32000000,81150692,35747336,116898028
"Jun 16, 2006",2006,Nacho Libre,32000000,80197993,19098469,99296462
"Nov 23, 1988",1988,Scrooged,32000000,59450353,0,59450353
"Aug 27, 2010",2010,Takers,32000000,57744720,12842548,70587268
"Apr 1, 2011",2011,Source Code,32000000,54712227,85716272,140428499
"Sep 10, 1999",1999,Stigmata,32000000,50041732,39400000,89441732
"Nov 10, 2000",2000,Men of Honor,32000000,48814909,33524574,82339483
"Apr 20, 2018",2018,I Feel Pretty,32000000,48795601,42758196,91553797
"Sep 2, 2005",2005,The Transporter 2,32000000,43095856,45882602,88978458
"Feb 18, 2011",2011,"Big Mommas: Like Father, Like Son",32000000,37915414,44417036,82332450
"Jan 15, 1993",1993,Alive,32000000,36299670,0,36299670
"Feb 23, 2007",2007,The Number 23,32000000,35193167,42400000,77593167
"Dec 14, 1979",1979,1941,32000000,34175000,60700000,94875000
"Oct 21, 2005",2005,Dreamer: Inspired by a True Story,32000000,33022286,6476074,39498360
"Sep 23, 2005",2005,A History of Violence,32000000,31493782,29984015,61477797
"Mar 15, 2013",2013,The Incredible Burt Wonderstone,32000000,22537881,4854728,27392609
"Feb 10, 1995",1995,The Quick and the Dead,32000000,18552460,0,18552460
"Apr 30, 2004",2004,Laws of Attraction,32000000,17848322,12100000,29948322
"Oct 12, 2018",2018,Bad Times at the El Royale,32000000,17839115,11365264,29204379
"Sep 3, 2010",2010,Going the Distance,32000000,17804299,25799691,43603990
"Oct 22, 1999",1999,Bringing Out The Dead,32000000,16640210,0,16640210
"Mar 19, 2010",2010,Repo Men,32000000,13942007,4253231,18195238
"Sep 14, 2007",2007,Dragon Wars: D-War,32000000,10977721,68937640,79915361
"Sep 6, 1996",1996,Bogus,32000000,4357406,0,4357406
"Mar 26, 1997",1997,Cats Don't Dance,32000000,3588602,0,3588602
"Dec 8, 1999",1999,Cradle Will Rock,32000000,2899970,0,2899970
"Dec 15, 2006",2006,The Good German,32000000,1308696,5369337,6678033
"Dec 31, 2004",2004,George and the Dragon,32000000,0,0,0
"Aug 15, 1979",1979,Apocalypse Now,31500000,78800000,2450485,81250485
"Apr 15, 2016",2016,Criminal,31500000,14708696,24062566,38771262
"Apr 12, 2013",2013,42,31000000,95020213,2450488,97470701
"Nov 2, 2012",2012,Flight,31000000,93772375,66786063,160558438
"Dec 29, 1995",1995,Mr. Hollandâs Opus,31000000,82582604,23700000,106282604
"Dec 18, 1985",1985,Out of Africa,31000000,79096868,179113992,258210860
"Jun 29, 1979",1979,Moonraker,31000000,70300000,140000000,210300000
"Mar 7, 2014",2014,The Grand Budapest Hotel,31000000,59076019,104905242,163981261
"Jul 29, 2015",2015,Vacation,31000000,58884188,43422312,102306500
"Jul 18, 1990",1990,Arachnophobia,31000000,53208180,0,53208180
"Feb 13, 2019",2019,Isnât it Romantic,31000000,48791187,0,48791187
"Apr 28, 2000",2000,Frequency,31000000,44983704,23095967,68079671
"Sep 28, 2001",2001,Hearts in Atlantis,31000000,24185781,6700000,30885781
"Jan 22, 2010",2010,Extraordinary Measures,31000000,12482741,3344243,15826984
"Aug 25, 2017",2017,Birth of the Dragon,31000000,6901965,318525,7220490
"Oct 20, 1995",1995,Get Shorty,30250000,72021008,43000000,115021008
"Jun 8, 1984",1984,Ghostbusters,30000000,242212467,53000000,295212467
"Nov 22, 1995",1995,Toy Story,30000000,191796233,172749283,364545516
"Aug 15, 2018",2018,Crazy Rich Asians,30000000,174532921,63566790,238099711
"Dec 27, 2002",2002,Chicago,30000000,170687518,136083027,306770545
"Jun 25, 1999",1999,Big Daddy,30000000,163479795,65161488,228641283
"Aug 10, 2001",2001,American Pie 2,30000000,145096820,141403180,286500000
"Feb 10, 2012",2012,The Vow,30000000,125014030,72604130,197618160
"Jun 10, 1994",1994,Speed,30000000,121248145,161951855,283200000
"Mar 2, 1990",1990,The Hunt for Red October,30000000,120709866,79790134,200500000
"Aug 16, 2013",2013,Lee Daniels' The Butler,30000000,116632095,60393403,177025498
"Sep 29, 2000",2000,Remember the Titans,30000000,115654751,21051932,136706683
"Aug 14, 2009",2009,District 9,30000000,115646235,96807196,212453431
"Jun 18, 2004",2004,Dodgeball: A True Underdog Story,30000000,114326736,53464968,167791704
"Nov 22, 1991",1991,The Addams Family,30000000,113502246,78000000,191502246
"Nov 10, 1995",1995,Ace Ventura: When Nature Calls,30000000,108360063,104039937,212400000
"Aug 3, 2001",2001,The Princess Diaries,30000000,108244774,57090000,165334774
"Mar 5, 1999",1999,Analyze This,30000000,106885658,70000000,176885658
"Sep 20, 1996",1996,The First Wives Club,30000000,105489203,76000000,181489203
"Dec 15, 2004",2004,Million Dollar Baby,30000000,100492203,131436024,231928227
"Sep 22, 1995",1995,Se7en,30000000,100125643,228000000,328125643
"Oct 8, 2003",2003,Mystic River,30000000,90135191,66686829,156822020
"Dec 18, 2015",2015,Sisters,30000000,87044645,18986015,106030660
"Nov 10, 1999",1999,Pokemon: The First Movie,30000000,85744662,77900000,163644662
"Nov 19, 2004",2004,SpongeBob SquarePants: The Movie,30000000,85416609,56634646,142051255
"Dec 4, 2009",2009,Up in the Air,30000000,83823381,83019358,166842739
"Jun 25, 2004",2004,The Notebook,30000000,81001787,35023236,116025023
"Apr 10, 2009",2009,Hannah Montana the Movie,30000000,79576189,89597017,169173206
"Jan 18, 2008",2008,27 Dresses,30000000,76808654,83439151,160247805
"Nov 17, 2000",2000,Rugrats in Paris,30000000,76501438,26783375,103284813
"Aug 18, 2017",2017,The Hitmanâs Bodyguard,30000000,75468583,97310084,172778667
"Dec 25, 1991",1991,The Prince of Tides,30000000,74787599,0,74787599
"Aug 12, 2005",2005,Four Brothers,30000000,74494381,18000000,92494381
"Dec 23, 1994",1994,Legends of the Fall,30000000,66502573,94000000,160502573
"Sep 28, 2012",2012,Looper,30000000,66486205,103980200,170466405
"Feb 1, 2013",2013,Warm Bodies,30000000,66380662,48740946,115121608
"Dec 13, 2002",2002,About Schmidt,30000000,65005217,42049267,107054484
"Jan 17, 2014",2014,The Nut Job,30000000,64251538,58278428,122529966
"Feb 16, 2001",2001,Down to Earth,30000000,64172251,7000000,71172251
"Aug 4, 1995",1995,Babe,30000000,63658910,182441090,246100000
"Aug 8, 2012",2012,Hope Springs,30000000,63536011,69549284,133085295
"Apr 18, 2008",2008,Forgetting Sarah Marshall,30000000,63172463,42000579,105173042
"Oct 8, 2004",2004,Friday Night Lights,30000000,61255921,694849,61950770
"Nov 17, 1989",1989,Harlem Nights,30000000,60857262,35000000,95857262
"Apr 25, 2008",2008,Baby Mama,30000000,60494212,3676235,64170447
"May 29, 1998",1998,Hope Floats,30000000,60110313,21418687,81529000
"Jan 9, 2009",2009,Bride Wars,30000000,58715510,56434914,115150424
"Aug 20, 2004",2004,Without a Paddle,30000000,58156435,6964845,65121280
"May 20, 2011",2011,Midnight in Paris,30000000,56816662,105686112,162502774
"Nov 22, 2017",2017,Darkest Hour,30000000,56443120,94364052,150807172
"Oct 5, 2005",2005,Wallace & Gromit: The Curse of the Were-Rabbit,30000000,56068547,141524605,197593152
"Dec 21, 2007",2007,P.S. I Love You,30000000,53695808,102073870,155769678
"Sep 23, 2005",2005,Corpse Bride,30000000,53359111,61411543,114770654
"May 11, 2018",2018,Life of the Party,30000000,53059911,12700000,65759911
"May 14, 2010",2010,Letters to Juliet,30000000,53032453,29116085,82148538
"Apr 6, 2001",2001,Blow,30000000,52990775,30291521,83282296
"Feb 12, 1999",1999,Message in a Bottle,30000000,52880016,0,52880016
"Jul 24, 2015",2015,Southpaw,30000000,52421953,41734503,94156456
"Jun 9, 1989",1989,Star Trek V: The Final Frontier,30000000,52210049,17989951,70200000
"Jul 28, 2017",2017,Atomic Blonde,30000000,51573925,46771498,98345423
"Jul 3, 2002",2002,Like Mike,30000000,51432423,11000000,62432423
"Mar 18, 1994",1994,Naked Gun 33 1/3: The Final Insult,30000000,51041856,0,51041856
"Dec 7, 2007",2007,Atonement,30000000,50980159,78799569,129779728
"May 24, 1985",1985,A View to a Kill,30000000,50327960,102300000,152627960
"Jan 14, 2005",2005,Racing Stripes,30000000,49772522,40183018,89955540
"Sep 18, 2015",2015,Sicario,30000000,46889293,37504456,84393749
"Sep 22, 1989",1989,Black Rain,30000000,45892212,0,45892212
"Jun 26, 1987",1987,Full Metal Jacket,30000000,45015999,0,45015999
"Jan 19, 2018",2018,Den of Thieves,30000000,44947622,35183769,80131391
"Apr 13, 2012",2012,The Three Stooges,30000000,44338224,9714025,54052249
"Jul 21, 2000",2000,Pokemon 2000,30000000,43746923,90200000,133946923
"Oct 24, 2014",2014,John Wick,30000000,43037835,33197166,76235001
"Jan 13, 2006",2006,Glory Road,30000000,42647449,151611,42799060
"Apr 24, 2015",2015,The Age of Adaline,30000000,42629776,26354760,68984536
"Aug 6, 2010",2010,Step Up 3D,30000000,42400223,123488894,165889117
"May 29, 2009",2009,Drag Me To Hell,30000000,42100625,49287862,91388487
"Apr 13, 2012",2012,The Cabin in the Woods,30000000,42073277,28616691,70689968
"Sep 19, 2003",2003,Secondhand Lions,30000000,42070939,5831627,47902566
"Nov 10, 2006",2006,Stranger Than Fiction,30000000,40435190,13137632,53572822
"Apr 8, 2011",2011,Hanna,30000000,40259119,25084575,65343694
"Aug 16, 2002",2002,Blue Crush,30000000,40118420,11500000,51618420
"Oct 19, 2007",2007,30 Days of Night,30000000,39568996,40707160,80276156
"Dec 19, 1986",1986,Little Shop of Horrors,30000000,38747385,0,38747385
"Sep 15, 2006",2006,Gridiron Gang,30000000,38432823,3025011,41457834
"Jul 20, 1988",1988,Midnight Run,30000000,38413606,43200000,81613606
"Jan 25, 2008",2008,Meet the Spartans,30000000,38233676,46413155,84646831
"Nov 13, 1987",1987,The Running Man,30000000,38122000,0,38122000
"Sep 13, 2013",2013,The Family,30000000,36918811,14159730,51078541
"Feb 9, 2018",2018,The 15:17 to Paris,30000000,36276286,19819914,56096200
"Nov 21, 1997",1997,Mortal Kombat: Annihilation,30000000,35927406,15400000,51327406
"Jul 1, 2011",2011,Larry Crowne,30000000,35608245,25840890,61449135
"Oct 18, 2013",2013,Carrie,30000000,35266619,47142901,82409520
"Apr 7, 2006",2006,Take the Lead,30000000,34742066,30648427,65390493
"Mar 2, 2018",2018,Death Wish,30000000,34017028,14558937,48575965
"Nov 24, 2010",2010,Love and Other Drugs,30000000,32367005,70349316,102716321
"Jun 3, 2015",2015,Entourage,30000000,32363404,14075134,46438538
"Jun 1, 2001",2001,What's the Worst That Could Happen?,30000000,32267774,6194297,38462071
"Feb 8, 2013",2013,Side Effects,30000000,32172757,34569381,66742138
"Sep 9, 2009",2009,9,30000000,31749894,16810105,48559999
"Jul 2, 2014",2014,Deliver Us from Evil,30000000,30577122,57379496,87956618
"Aug 1, 2014",2014,Get on Up,30000000,30569935,2769933,33339868
"Dec 25, 2017",2017,Mollyâs Game,30000000,28780744,24515680,53296424
"Apr 27, 2012",2012,The Five-Year Engagement,30000000,28700285,32923534,61623819
"Apr 2, 2004",2004,The Prince & Me,30000000,28165882,1190875,29356757
"Jul 15, 2011",2011,Winnie the Pooh,30000000,26692846,23452761,50145607
"May 15, 1998",1998,Bulworth,30000000,26528684,2674699,29203383
"Jun 13, 2003",2003,Dumb and Dumberer: When Harry Met Lloyd,30000000,26214846,0,26214846
"Sep 14, 2018",2018,White Boy Rick,30000000,24004833,1943150,25947983
"Aug 4, 1995",1995,Virtuosity,30000000,23998226,0,23998226
"Sep 18, 1998",1998,One True Thing,30000000,23337196,3371000,26708196
"Feb 4, 2011",2011,Sanctum,30000000,23209310,85747788,108957098
"Jul 21, 2006",2006,My Super Ex-Girlfriend,30000000,22530295,38242561,60772856
"Aug 25, 2017",2017,Ballerina,30000000,21858070,75034759,96892829
"Sep 17, 2004",2004,Mr. 3000,30000000,21800302,26994,21827296
"Nov 19, 2010",2010,The Next Three Days,30000000,21148651,46107265,67255916
"Jan 12, 2018",2018,Proud Mary,30000000,20868638,840901,21709539
"Aug 6, 2004",2004,Little Black Book,30000000,20422207,1336164,21758371
"Jan 19, 2005",2005,Assault On Precinct 13,30000000,20040895,16000000,36040895
"Oct 4, 2013",2013,Runner Runner,30000000,19316646,41196034,60512680
"Feb 6, 1998",1998,The Replacement Killers,30000000,19035741,0,19035741
"Apr 28, 2017",2017,Baahubali 2: The Conclusion,30000000,18985794,244517120,263502914
"Mar 3, 2006",2006,Ultraviolet,30000000,18522064,12440048,30962112
"Oct 21, 2005",2005,North Country,30000000,18324242,5352529,23676771
"Aug 19, 2011",2011,Fright Night,30000000,18298649,22222000,40520649
"Sep 15, 2017",2017,mother!,30000000,17800004,24731072,42531076
"Oct 9, 2015",2015,Steve Jobs,30000000,17766658,17812349,35579007
"Jul 17, 2002",2002,Eight Legged Freaks,30000000,17266505,19455806,36722311
"Jul 19, 1996",1996,Fled,30000000,17192205,2700000,19892205
"Jun 4, 2010",2010,Splice,30000000,17010170,11532324,28542494
"Apr 18, 2008",2008,88 Minutes,30000000,16930884,16024515,32955399
"Apr 9, 2004",2004,The Whole Ten Yards,30000000,16323969,10000000,26323969
"Aug 1, 1986",1986,Howard the Duck,30000000,16295774,0,16295774
"Oct 24, 2008",2008,Pride and Glory,30000000,15740721,27700000,43440721
"Aug 26, 2005",2005,The Cave,30000000,15007991,12140000,27147991
"Apr 30, 2004",2004,Godsend,30000000,14334645,2576063,16910708
"Jun 20, 2003",2003,Alex & Emma,30000000,14208384,1150199,15358583
"Sep 3, 2004",2004,Wicker Park,30000000,13001257,8575819,21577076
"Dec 25, 2005",2005,The New World,30000000,12712093,13472307,26184400
"Jun 29, 2007",2007,Evening,30000000,12406646,478928,12885574
"Jan 18, 2013",2013,The Last Stand,30000000,12050299,36280458,48330757
"Jan 15, 1999",1999,In Dreams,30000000,12017369,0,12017369
"Mar 12, 1999",1999,Wing Commander,30000000,11578022,0,11578022
"Jan 12, 2001",2001,Antitrust,30000000,10965209,6900000,17865209
"Mar 8, 2013",2013,Dead Man Down,30000000,10895295,8704679,19599974
"Apr 29, 2011",2011,Hoodwinked Too: Hood vs. Evil,30000000,10143779,13209332,23353111
"Apr 10, 2009",2009,Dragonball Evolution,30000000,9362785,48865675,58228460
"Sep 24, 2004",2004,First Daughter,30000000,9055010,1364074,10419084
"Apr 14, 2017",2017,The Lost City of Z,30000000,8574339,8547484,17121823
"Sep 9, 2005",2005,An Unfinished Life,30000000,8535575,10000000,18535575
"Feb 3, 2017",2017,The Space Between Us,30000000,7885294,8596111,16481405
"Dec 25, 2009",2009,The Imaginarium of Doctor Parnassus,30000000,7689607,56663000,64352607
"Jan 14, 2011",2011,Barney's Version,30000000,7502560,1343015,8845575
"Sep 20, 2002",2002,Trapped,30000000,6916869,0,6916869
"Aug 31, 2018",2018,Kin,30000000,5718096,4378725,10096821
"Jun 1, 1984",1984,Once Upon a Time in America,30000000,5321508,254140,5575648
"Sep 22, 2017",2017,Stronger,30000000,4211129,4575623,8786752
"Jan 22, 1999",1999,Gloria,30000000,4167493,800000,4967493
"Sep 21, 2007",2007,The Assassination of Jesse James by the Coward Robert Ford,30000000,3909149,11404482,15313631
"Dec 29, 2004",2004,The Merchant of Venice,30000000,3765585,15000000,18765585
"Apr 2, 2003",2003,The Good Thief,30000000,3517797,2942961,6460758
"Aug 17, 2005",2005,Supercross,30000000,3102550,150000,3252550
"Dec 29, 2006",2006,Miss Potter,30000000,3005605,32885652,35891257
"May 5, 2006",2006,Wu ji,30000000,669625,35200309,35869934
"Jun 14, 2019",2019,Shaft,30000000,600000,0,600000
"Sep 23, 2011",2011,Machine Gun Preacher,30000000,538690,3183298,3721988
"Feb 2, 2018",2018,Bilal: A New Breed of Hero,30000000,490973,157626,648599
"Jun 15, 2007",2007,DOA: Dead or Alive,30000000,480314,7275372,7755686
"Feb 19, 2010",2010,Le Petit Nicolas,30000000,201857,52137709,52339566
"Oct 7, 2011",2011,Xinhai geming,30000000,135739,8457415,8593154
"Feb 21, 2008",2008,Genghis Khan: To the Ends of the Earth and Sea,30000000,3892,4870606,4874498
"Jan 30, 2015",2015,Wild Card,30000000,3200,4312589,4315789
"Jun 5, 2015",2015,United Passions,30000000,918,167914,168832
"Dec 31, 2010",2010,Konferenz der Tiere,30000000,0,53048539,53048539
"Dec 1, 2015",2015,Grace of Monaco,30000000,0,25199891,25199891
"Mar 8, 2016",2016,Savva. Serdtse voyna,30000000,0,5015080,5015080
"Dec 14, 2007",2007,Goodbye Bafana,30000000,0,2717302,2717302
"Dec 31, 2013",2013,Space Pirate Captain Harlock,30000000,0,310985,310985
"Dec 31, 2003",2003,Ripley's Game,30000000,0,0,0
"Feb 24, 2017",2017,Collide,29200000,2280004,3186694,5466698
"May 15, 2015",2015,Pitch Perfect 2,29000000,184296230,103329238,287625468
"Nov 18, 2005",2005,Walk the Line,29000000,119519402,68188093,187707495
"Sep 28, 2018",2018,Night School,29000000,77339130,25669662,103008792
"Apr 8, 2016",2016,The Boss,29000000,63077560,15574647,78652207
"Dec 27, 1995",1995,12 Monkeys,29000000,57141459,111700000,168841459
"Sep 12, 2003",2003,Once Upon a Time in Mexico,29000000,56330657,41082870,97413527
"Apr 14, 2000",2000,Keeping the Faith,29000000,37036404,8300000,45336404
"Aug 18, 2017",2017,Logan Lucky,29000000,27778642,16485629,44264271
"Aug 12, 2016",2016,Florence Foster Jenkins,29000000,27383770,28616569,56000339
"Feb 13, 1998",1998,The Borrowers,29000000,22619589,31426243,54045832
"Dec 5, 2008",2008,Frost/Nixon,29000000,18622031,9830914,28452945
"Nov 12, 2004",2004,Seed of Chucky,29000000,17016190,7700000,24716190
"Aug 23, 2002",2002,Serving Sara,29000000,16930185,3215965,20146150
"Dec 31, 2002",2002,Confessions of a Dangerous Mind,29000000,16007718,17006087,33013805
"Aug 26, 2009",2009,Taking Woodstock,29000000,7460204,2606162,10066366
"Nov 6, 1987",1987,Cry Freedom,29000000,5899797,20000000,25899797
"Sep 30, 2019",2019,Unhinged,29000000,0,0,0
"Sep 24, 1999",1999,Mumford,28700000,4559569,0,4559569
"Mar 4, 2005",2005,The Jacket,28500000,6301131,9151847,15452978
"Nov 11, 1992",1992,Aladdin,28000000,217350219,286700000,504050219
"May 23, 1984",1984,Indiana Jones and the Temple of Doom,28000000,179880271,153200000,333080271
"Aug 14, 2015",2015,Straight Outta Compton,28000000,161197785,40985196,202182981
"Jul 21, 2017",2017,Girls Trip,28000000,115108515,25777838,140886353
"Nov 20, 1998",1998,The Rugrats Movie,28000000,100494685,40400000,140894685
"Jul 15, 1988",1988,Die Hard,28000000,81350242,57759104,139109346
"Apr 6, 2001",2001,Along Came a Spider,28000000,74058698,31100387,105159085
"Nov 1, 2017",2017,A Bad Moms Christmas,28000000,72110659,55599891,127710550
"Feb 14, 2013",2013,Safe Haven,28000000,71399120,22651831,94050951
"Dec 11, 2015",2015,The Big Short,28000000,70259870,62902882,133162752
"Nov 7, 2008",2008,Role Models,28000000,67300955,27199871,94500826
"Oct 10, 2014",2014,"Alexander and the Terrible, Horrible, No Good, Very Bad Day",28000000,66954149,34425138,101379287
"Feb 6, 2004",2004,Miracle,28000000,64378093,96612,64474705
"Jan 28, 2013",2013,Last Vegas,28000000,63914167,49000000,112914167
"Jan 26, 2001",2001,The Wedding Planner,28000000,60400856,34327673,94728529
"Mar 19, 2004",2004,Dawn of the Dead,28000000,58990765,44462110,103452875
"Jun 26, 1981",1981,For Your Eyes Only,28000000,54800000,140500000,195300000
"Jun 15, 2018",2018,Tag,28000000,54730625,22295561,77026186
"Dec 14, 2001",2001,The Royal Tenenbaums,28000000,52353636,19077240,71430876
"Apr 25, 2003",2003,Identity,28000000,52131264,30052419,82183683
"Oct 5, 2001",2001,Serendipity,28000000,50255310,27221987,77477297
"Apr 16, 2010",2010,Kick-Ass,28000000,48071303,49459831,97531134
"Sep 28, 2001",2001,Zoolander,28000000,45172250,15608731,60780981
"Sep 16, 1994",1994,Timecop,28000000,44853581,57200000,102053581
"Jul 27, 2007",2007,No Reservations,28000000,43107979,48835977,91943956
"Jul 16, 1993",1993,Hocus Pocus,28000000,39360491,0,39360491
"Nov 11, 2005",2005,Pride & Prejudice,28000000,38372662,88176945,126549607
"Aug 12, 2011",2011,30 Minutes or Less,28000000,37053924,3912792,40966716
"Dec 22, 2000",2000,Dracula 2000,28000000,33000377,0,33000377
"Jun 25, 1982",1982,Blade Runner,28000000,32656328,6686584,39342912
"Apr 7, 1995",1995,Rob Roy,28000000,31390587,0,31390587
"Feb 21, 2014",2014,3 Days to Kill,28000000,30697999,8261901,38959900
"Aug 16, 2013",2013,Kick-Ass 2,28000000,28795985,34333924,63129909
"Oct 12, 2007",2007,We Own the Night,28000000,28563179,26744678,55307857
"Sep 19, 2014",2014,A Walk Among the Tombstones,28000000,26017685,36090902,62108587
"Jan 15, 2010",2010,The Spy Next Door,28000000,24307106,22445752,46752858
"Apr 25, 2014",2014,Brick Mansions,28000000,20396829,53024395,73421224
"May 12, 2006",2006,Just My Luck,28000000,17326650,20833255,38159905
"Oct 13, 2000",2000,Lost Souls,28000000,16779636,14540657,31320293
"Aug 21, 2015",2015,American Ultra,28000000,14439985,15855043,30295028
"Apr 18, 2003",2003,Winged Migration,28000000,11689053,27445930,39134983
"Feb 5, 2016",2016,Pride and Prejudice and Zombies,28000000,10907291,5731009,16638300
"Oct 1, 1999",1999,"Mystery, Alaska",28000000,8891623,0,8891623
"Aug 24, 2001",2001,John Carpenterâs Ghosts of Mars,28000000,8434601,0,8434601
"Jul 11, 1997",1997,A Simple Wish,28000000,8165213,0,8165213
"Oct 30, 2015",2015,Our Brand is Crisis,28000000,7002261,1592297,8594558
"Dec 25, 1997",1997,Kundun,28000000,5686694,0,5686694
"Oct 3, 2008",2008,How to Lose Friends & Alienate People,28000000,2775593,9255850,12031443
"Dec 31, 2007",2007,Alatriste,28000000,0,22860477,22860477
"Jun 1, 2007",2007,Knocked Up,27500000,148761765,70504187,219265952
"Jun 10, 1983",1983,Octopussy,27500000,67900000,119600000,187500000
"Jun 26, 2009",2009,My Sister's Keeper,27500000,49200230,47472772,96673002
"Feb 8, 2008",2008,Welcome Home Roscoe Jenkins,27500000,42436517,1171110,43607627
"Jan 13, 2012",2012,Joyful Noise,27500000,30932113,225801,31157914
"Dec 14, 1984",1984,A Passage to India,27500000,27187653,0,27187653
"Dec 25, 2006",2006,Notes on a Scandal,27500000,17510118,33068293,50578411
"Oct 19, 2007",2007,Rendition,27500000,9736045,17203880,26939925
"Oct 28, 2011",2011,Anonymous,27500000,4463292,11352217,15815509
"Mar 18, 2011",2011,Limitless,27000000,79249455,76315464,155564919
"Dec 6, 1991",1991,Star Trek VI: The Undiscovered Country,27000000,74888996,22011004,96900000
"Jun 7, 2002",2002,The Divine Secrets of the Ya-Ya Sisterhood,27000000,69586544,4240224,73826768
"Oct 3, 1997",1997,Kiss the Girls,27000000,60527873,0,60527873
"Jun 20, 1980",1980,The Blues Brothers,27000000,57229890,0,57229890
"Dec 25, 1994",1994,The Jungle Book,27000000,44342956,0,44342956
"Aug 6, 2008",2008,The Sisterhood of the Traveling Pants 2,27000000,44089964,180167,44270131
"May 13, 2016",2016,Money Monster,27000000,41012075,52454020,93466095
"May 17, 2002",2002,About a Boy,27000000,40803000,89956651,130759651
"Aug 19, 2011",2011,Spy Kids: All the Time in the World,27000000,38536376,42144807,80681183
"Jul 16, 1999",1999,Lake Placid,27000000,31770413,0,31770413
"Apr 7, 2006",2006,Lucky Number Slevin,27000000,22495466,33000000,55495466
"Oct 21, 1983",1983,The Right Stuff,27000000,21500000,0,21500000
"Jul 20, 1984",1984,Die Unendliche Geschichte,27000000,21300000,92049,21392049
"Feb 27, 1998",1998,Dark City,27000000,14435076,12821985,27257061
"Sep 19, 2008",2008,The Duchess,27000000,13848978,31311132,45160110
"Oct 1, 2010",2010,Case 39,27000000,13261851,15511976,28773827
"Jun 10, 2005",2005,The Honeymooners,27000000,12834849,339577,13174426
"Jun 21, 1985",1985,Return to Oz,27000000,10618813,0,10618813
"Mar 27, 1998",1998,The Newton Boys,27000000,10341093,0,10341093
"Aug 27, 2004",2004,Suspect Zero,27000000,8712564,0,8712564
"Nov 2, 2007",2007,Martian Child,27000000,7500310,1851779,9352089
"Oct 18, 2002",2002,Formula 51,27000000,5204007,0,5204007
"Nov 24, 1999",1999,Flawless,27000000,4485485,0,4485485
"May 13, 2005",2005,Mindhunters,27000000,4476235,12090000,16566235
"Oct 17, 2008",2008,What Just Happened,27000000,1090947,1321176,2412123
"Dec 12, 2003",2003,The Statement,27000000,765637,779427,1545064
"Dec 31, 2006",2006,The Magic Flute,27000000,0,0,0
"Nov 23, 2016",2016,Rules Donât Apply,26700000,3652206,219242,3871448
"Jan 16, 2009",2009,Paul Blart: Mall Cop,26000000,146336178,39568572,185904750
"Aug 6, 2003",2003,Freaky Friday,26000000,110222438,50600000,160822438
"Aug 19, 2005",2005,The 40 Year-old Virgin,26000000,109449237,67894993,177344230
"Dec 11, 1998",1998,Shakespeare in Love,26000000,100317794,179182206,279500000
"Dec 21, 1990",1990,Kindergarten Cop,26000000,91457688,110542312,202000000
"Aug 6, 2008",2008,Pineapple Express,26000000,87341380,15062639,102404019
"Dec 22, 1993",1993,Philadelphia,26000000,77324422,124000000,201324422
"Jul 31, 1998",1998,Ever After: A Cinderella Story,26000000,65705772,0,65705772
"Aug 10, 1990",1990,Flatliners,26000000,61308153,0,61308153
"Aug 15, 2003",2003,Open Range,26000000,58331254,10282738,68613992
"Aug 19, 2005",2005,Red Eye,26000000,57891803,38774683,96666486
"Dec 9, 2011",2011,New Yearâs Eve,26000000,54544638,92305635,146850273
"Jun 15, 1977",1977,A Bridge Too Far,26000000,50800000,0,50800000
"Apr 26, 2013",2013,Pain & Gain,26000000,49875291,31400000,81275291
"Jan 31, 2003",2003,Final Destination 2,26000000,46896664,43500000,90396664
"Dec 22, 2000",2000,"O Brother, Where Art Thou?",26000000,45506619,30257195,75763814
"Dec 29, 2004",2004,In Good Company,26000000,45489752,18000000,63489752
"Jan 22, 2010",2010,Legion,26000000,40168080,27479494,67647574
"Aug 29, 2012",2012,Lawless,26000000,37397291,16996396,54393687
"Mar 29, 2002",2002,Clockstoppers,26000000,36985501,1803327,38788828
"Jul 10, 1985",1985,Silverado,26000000,33200000,0,33200000
"Dec 4, 2009",2009,Brothers,26000000,28544157,16499713,45043870
"Oct 17, 2014",2014,The Best of Me,26000000,26766213,14293205,41059418
"Mar 12, 2004",2004,Agent Cody Banks 2: Destination London,26000000,23514247,5188836,28703083
"Aug 3, 2001",2001,Original Sin,26000000,16521410,0,16521410
"Apr 27, 2012",2012,The Raven,26000000,16008272,14593529,30601801
"Feb 20, 2004",2004,Welcome to Mooseport,26000000,14469428,0,14469428
"Jan 27, 1995",1995,Highlander: The Final Dimension,26000000,13738574,0,13738574
"Jul 10, 2015",2015,Self/Less,26000000,12279691,21387628,33667319
"Aug 24, 2001",2001,The Curse of the Jade Scorpion,26000000,7496522,11000000,18496522
"Oct 18, 2013",2013,The Fifth Estate,26000000,3254172,2900000,6154172
"Feb 21, 1997",1997,Blood and Wine,26000000,1083350,0,1083350
"Mar 21, 2014",2014,Blood Ties,26000000,42472,2881487,2923959
"Aug 24, 1997",1997,The Grimm Brothers' Snow White,26000000,5000,0,5000
"Jun 30, 2015",2015,Viy,26000000,0,34246770,34246770
"Mar 17, 2015",2015,Accidental Love,26000000,0,135436,135436
"Apr 24, 2015",2015,The Face of an Angel,26000000,0,0,0
"May 17, 1996",1996,Flipper,25530000,20080020,10513293,30593313
"Aug 31, 2005",2005,The Constant Gardener,25500000,33579798,52721801,86301599
"Oct 17, 2008",2008,W.,25100000,25534493,3041285,28575778
"Feb 25, 2004",2004,The Passion of the Christ,25000000,370782930,251558994,622341924
"Nov 24, 1993",1993,Mrs. Doubtfire,25000000,219195051,222090952,441286003
"Dec 16, 1988",1988,Rain Man,25000000,172825435,239974565,412800000
"Aug 10, 2011",2011,The Help,25000000,169705587,43414417,213120004
"Dec 25, 2016",2016,Hidden Figures,25000000,169607287,62164429,231771716
"Dec 12, 2008",2008,Gran Torino,25000000,148095302,126447783,274543085
"Jan 30, 2009",2009,Taken,25000000,145000989,81940596,226941585
"Jan 17, 2014",2014,Ride Along,25000000,134202565,19531235,153733800
"Nov 25, 1992",1992,The Bodyguard,25000000,121945720,288953319,410899039
"Dec 15, 1993",1993,Schindlerâs List,25000000,96898818,225298314,322197132
"Jul 2, 2003",2003,"Legally Blonde 2: Red, White & Blonde",25000000,90639088,34700000,125339088
"Mar 26, 2004",2004,Scooby-Doo 2: Monsters Unleashed,25000000,84185387,97000000,181185387
"Jul 9, 2004",2004,Anchorman: The Legend of Ron Burgundy,25000000,84136909,5339356,89476265
"Aug 15, 2003",2003,Freddy vs. Jason,25000000,82622655,31953748,114576403
"Feb 16, 2007",2007,Bridge to Terabithia,25000000,82234139,55750649,137984788
"Dec 21, 2001",2001,Jimmy Neutron: Boy Genius,25000000,80936232,22056304,102992536
"Jan 18, 2008",2008,Cloverfield,25000000,80048433,91253793,171302226
"Feb 5, 2010",2010,Dear John,25000000,80014842,62018667,142033509
"Mar 22, 1991",1991,Teenage Mutant Ninja Turtles II: The Secret of the Ooze,25000000,78656813,0,78656813
"Dec 25, 2012",2012,Parental Guidance,25000000,77267296,43565087,120832383
"Jun 3, 1987",1987,The Untouchables,25000000,76270454,0,76270454
"Nov 9, 2007",2007,No Country for Old Men,25000000,74273505,89762248,164035753
"Apr 13, 2001",2001,Bridget Jones's Diary,25000000,71500556,210026602,281527158
"Dec 15, 2000",2000,Chocolat,25000000,71309760,81190583,152500343
"Jan 21, 2011",2011,No Strings Attached,25000000,70662220,78565858,149228078
"Jan 13, 2012",2012,Contraband,25000000,66528000,31878855,98406855
"Jan 27, 2017",2017,A Dogâs Purpose,25000000,64321890,139349735,203671625
"Apr 20, 2012",2012,The Lucky One,25000000,60457138,36176695,96633833
"Dec 25, 1993",1993,Tombstone,25000000,56505065,0,56505065
"Mar 22, 2000",2000,Romeo Must Die,25000000,55973336,35063424,91036760
"Jun 6, 2006",2006,The Omen,25000000,54607383,64688201,119295584
"Feb 10, 2006",2006,Final Destination 3,25000000,54098051,58700000,112798051
"Apr 22, 2011",2011,Madea's Big Happy Family,25000000,53345287,815531,54160818
"Dec 13, 2013",2013,Tyler Perry's A Madea Christmas,25000000,52543354,0,52543354
"Nov 12, 2004",2004,Finding Neverland,25000000,51676606,63359502,115036108
"Jan 27, 2012",2012,The Grey,25000000,51580136,29669040,81249176
"Jan 28, 2005",2005,Hide and Seek,25000000,51100486,72596255,123696741
"May 23, 1986",1986,Cobra,25000000,49042224,0,49042224
"Aug 22, 2008",2008,The House Bunny,25000000,48237389,23153212,71390601
"Mar 14, 2003",2003,Agent Cody Banks,25000000,47545060,10695398,58240458
"Jan 27, 2006",2006,Nanny McPhee,25000000,47279279,81466299,128745578
"Sep 19, 1990",1990,Goodfellas,25000000,46743809,33538,46777347
"Aug 15, 2014",2014,The Giver,25000000,45090374,21449831,66540205
"Dec 9, 1983",1983,Scarface,25000000,44942821,0,44942821
"Jul 18, 1997",1997,Nothing To Lose,25000000,44480039,20114022,64594061
"Nov 20, 1987",1987,The Last Emperor,25000000,43984987,20086,44005073
"Nov 20, 2015",2015,The Night Before,25000000,43035725,9391621,52427346
"Oct 15, 1993",1993,The Beverly Hillbillies,25000000,42222647,13375834,55598481
"Dec 27, 2002",2002,The Hours,25000000,41675994,55354474,97030468
"Aug 22, 1997",1997,Money Talks,25000000,41076865,0,41076865
"Dec 26, 2007",2007,There Will Be Blood,25000000,40222514,36986197,77208711
"Dec 20, 2002",2002,The Wild Thornberrys Movie,25000000,40108697,20586040,60694737
"Jun 13, 2003",2003,Rugrats Go Wild,25000000,39402572,16040460,55443032
"Jun 1, 2005",2005,The Sisterhood of the Traveling Pants,25000000,39053061,2507056,41560117
"May 31, 2002",2002,Undercover Brother,25000000,38230435,2565710,40796145
"Dec 25, 2013",2013,August: Osage County,25000000,37738810,13000000,50738810
"Jul 6, 2001",2001,Kiss of the Dragon,25000000,36833473,0,36833473
"May 16, 2014",2014,Million Dollar Arm,25000000,36447959,2769953,39217912
"Jan 1, 2004",2004,Beauty Shop,25000000,36351350,2000000,38351350
"Apr 4, 2003",2003,What a Girl Wants,25000000,35990505,0,35990505
"Aug 29, 2003",2003,Jeepers Creepers II,25000000,35623801,84300000,119923801
"Sep 7, 2018",2018,Peppermint,25000000,35418723,16382035,51800758
"Sep 21, 2007",2007,Good Luck Chuck,25000000,35017297,24166524,59183821
"Feb 28, 2003",2003,Cradle 2 the Grave,25000000,34657731,21777211,56434942
"Mar 17, 2006",2006,She's the Man,25000000,33889159,21390449,55279608
"Dec 10, 2014",2014,The Gambler,25000000,33680992,5037039,38718031
"Aug 24, 2007",2007,Mr. Beanâs Holiday,25000000,33302167,201679175,234981342
"Apr 29, 2016",2016,Motherâs Day,25000000,32492859,19874163,52367022
"Oct 16, 1998",1998,Bride of Chucky,25000000,32404188,18288000,50692188
"Feb 17, 2017",2017,Fist Fight,25000000,32187017,8099399,40286416
"Nov 21, 2007",2007,August Rush,25000000,31664162,34217941,65882103
"Aug 27, 2004",2004,Anacondas: The Hunt for the Blood Orchid,25000000,31526393,38800000,70326393
"Dec 9, 2011",2011,The Sitter,25000000,30542576,8206828,38749404
"Nov 6, 1998",1998,Elizabeth,25000000,30082699,52067943,82150642
"Sep 23, 1970",1970,"Tora, Tora, Tora",25000000,29548291,0,29548291
"Jan 23, 1998",1998,Spice World,25000000,29342592,26700000,56042592
"Apr 11, 2014",2014,Draft Day,25000000,28842237,1005243,29847480
"Sep 23, 1994",1994,The Shawshank Redemption,25000000,28241469,65623,28307092
"Feb 3, 2017",2017,Rings,25000000,27793018,55124265,82917283
"May 22, 2009",2009,Dance Flick,25000000,25794018,6430606,32224624
"Apr 20, 2001",2001,Crocodile Dundee in Los Angeles,25000000,25590119,13802992,39393111
"Jul 26, 1996",1996,Kingpin,25000000,25023424,7200000,32223424
"Mar 18, 2005",2005,Ice Princess,25000000,24381334,1351000,25732334
"Aug 26, 2011",2011,Don't Be Afraid of the Dark,25000000,24046682,15079745,39126427
"Apr 23, 2010",2010,The Losers,25000000,23591432,6272408,29863840
"Apr 24, 2009",2009,Fighting,25000000,23091010,9740697,32831707
"Aug 24, 2007",2007,War,25000000,22486409,18200000,40686409
"Apr 7, 1995",1995,Don Juan DeMarco,25000000,22032635,0,22032635
"Apr 22, 2005",2005,A Lot Like Love,25000000,21835784,20085806,41921590
"May 1, 1998",1998,He Got Game,25000000,21567853,844095,22411948
"Feb 11, 2011",2011,The Eagle,25000000,19490041,19503507,38993548
"Aug 5, 2015",2015,Shaun the Sheep,25000000,19375982,82549179,101925161
"Sep 2, 2011",2011,Shark Night 3D,25000000,18877153,0,18877153
"Mar 24, 2017",2017,CHiPS,25000000,18600152,4590140,23190292
"Oct 11, 2002",2002,Punch-Drunk Love,25000000,17791031,6800000,24591031
"Feb 20, 2004",2004,Eurotrip,25000000,17718223,3000000,20718223
"Dec 22, 2017",2017,Father Figures,25000000,17501244,3537197,21038441
"Apr 4, 2008",2008,The Ruins,25000000,17432844,5477719,22910563
"Oct 25, 2013",2013,The Counselor,25000000,16973715,54035619,71009334
"Dec 8, 2006",2006,Unaccompanied Minors,25000000,16655224,5315607,21970831
"Dec 7, 2018",2018,Mary Queen of Scots,25000000,16468499,30266234,46734733
"Apr 1, 1988",1988,"Bright Lights, Big City",25000000,16118077,0,16118077
"Nov 15, 2002",2002,Half Past Dead,25000000,15567860,3665420,19233280
"Apr 18, 1986",1986,Legend,25000000,15502112,8004125,23506237
"Jul 26, 1996",1996,The Adventures of Pinocchio,25000000,15382170,21300000,36682170
"Sep 30, 2005",2005,The Greatest Game Ever Played,25000000,15331289,136977,15468266
"Nov 6, 2009",2009,The Box,25000000,15051977,19304783,34356760
"Mar 3, 2000",2000,The Next Best Thing,25000000,14983572,9372190,24355762
"Oct 8, 2010",2010,My Soul to Take,25000000,14744435,1983035,16727470
"Apr 9, 2004",2004,The Girl Next Door,25000000,14589444,17045706,31635150
"Aug 15, 2008",2008,Fly Me To the Moon,25000000,14543943,28986338,43530281
"Sep 13, 1996",1996,Maximum Risk,25000000,14102929,37600000,51702929
"Sep 13, 2002",2002,Stealing Harvard,25000000,13973532,0,13973532
"Aug 3, 2007",2007,Hot Rod,25000000,13938332,396069,14334401
"Sep 9, 2011",2011,Warrior,25000000,13657115,10558270,24215385
"Dec 24, 1999",1999,Angela's Ashes,25000000,13038660,0,13038660
"Sep 22, 2017",2017,Battle of the Sexes,25000000,12638526,5806853,18445379
"Dec 21, 2012",2012,Cirque du Soleil: Worlds Away,25000000,12512862,15500000,28012862
"Nov 13, 2015",2015,The 33,25000000,12227722,16172993,28400715
"Jun 21, 1985",1985,Lifeforce,25000000,11603545,0,11603545
"Apr 15, 2011",2011,The Conspirator,25000000,11538204,4369207,15907411
"Jul 3, 2002",2002,The Powerpuff Girls,25000000,11411644,5014057,16425701
"Jun 3, 2005",2005,The Lords of Dogtown,25000000,11273517,2150848,13424365
"Jul 1, 1986",1986,Big Trouble in Little China,25000000,11100000,0,11100000
"Oct 11, 1996",1996,Michael Collins,25000000,11092559,16480285,27572844
"Mar 28, 2008",2008,Stop-Loss,25000000,10915744,313291,11229035
"Oct 8, 1993",1993,Gettysburg,25000000,10731997,0,10731997
"Oct 18, 2002",2002,Abandon,25000000,10719367,1500000,12219367
"Sep 16, 2011",2011,Straw Dogs,25000000,10324441,929380,11253821
"Aug 13, 1999",1999,Brokedown Palace,25000000,10115014,1000752,11115766
"Aug 16, 2002",2002,Possession,25000000,10103647,4702165,14805812
"Apr 19, 1996",1996,Mrs. Winterbourne,25000000,10039566,0,10039566
"May 17, 1991",1991,Stone Cold,25000000,9286314,0,9286314
"Jan 25, 2019",2019,Serenity,25000000,8547045,2819984,11367029
"Nov 25, 2009",2009,The Road,25000000,8114270,21092462,29206732
"Oct 12, 2018",2018,Beautiful Boy,25000000,7634767,5396657,13031424
"Apr 6, 2007",2007,The Hoax,25000000,7164995,0,7164995
"Mar 15, 2019",2019,Captive State,25000000,5958315,3034985,8993300
"Aug 17, 1984",1984,Sheena,25000000,5778353,0,5778353
"Sep 2, 2005",2005,Underclassman,25000000,5654777,0,5654777
"Mar 23, 2001",2001,Say It Isn't So,25000000,5516708,0,5516708
"Dec 7, 2005",2005,The World's Fastest Indian,25000000,5128124,13863164,18991288
"Apr 25, 2008",2008,Deception,25000000,4598506,8251527,12850033
"Mar 1, 1995",1995,Tank Girl,25000000,4064333,0,4064333
"Apr 22, 2005",2005,King's Ransom,25000000,4008527,41000,4049527
"Oct 3, 2008",2008,Blindness,25000000,3073392,16979566,20052958
"Apr 13, 2018",2018,Sgt. Stubby: An American Hero,25000000,3054285,591672,3645957
"Dec 16, 2011",2011,Carnage,25000000,2546747,35565407,38112154
"Sep 1, 2017",2017,Tulip Fever,25000000,2455635,4337133,6792768
"Jan 6, 2006",2006,BloodRayne,25000000,2405420,1306213,3711633
"Nov 20, 2015",2015,Legend,25000000,1872994,40552456,42425450
"Nov 20, 2009",2009,Bad Lieutenant: Port of Call New Orleans,25000000,1702112,10711837,12413949
"Jan 29, 2016",2016,Jane Got a Gun,25000000,1513793,2257552,3771345
"Nov 25, 2009",2009,Me and Orson Welles,25000000,1190003,0,1190003
"Sep 16, 2005",2005,Venom,25000000,881745,0,881745
"Oct 14, 2005",2005,Where the Truth Lies,25000000,872142,543514,1415656
"Sep 11, 1998",1998,Without Limits,25000000,780326,0,780326
"Mar 22, 2013",2013,On the Road,25000000,720828,8592474,9313302
"Aug 24, 2012",2012,Les petits mouchoirs,25000000,205505,48325382,48530887
"Jun 30, 2010",2010,Love Ranch,25000000,137885,8264,146149
"Apr 24, 2015",2015,Yi ge ren de wu lin,25000000,129115,0,129115
"Dec 31, 2010",2010,Sammy's avonturen: De geheime doorgang,25000000,0,71594792,71594792
"Dec 31, 2010",2010,Belka i Strelka. Zvezdnye sobaki,25000000,0,9445081,9445081
"Dec 31, 2017",2017,Matilda,25000000,0,9370285,9370285
"Oct 4, 2011",2011,La vÃ©ritable histoire du Chat BottÃ©,25000000,0,8208594,8208594
"Jul 8, 2011",2011,Ironclad,25000000,0,5297411,5297411
"May 10, 2019",2019,The Professor and the Madman,25000000,0,5227233,5227233
"Mar 10, 2015",2015,Red Sky,25000000,0,91116,91116
"Jan 1, 1970",1970,Waterloo,25000000,0,0,0
"Jan 10, 2014",2014,The Adventurer: The Curse of the Midas Box,25000000,0,0,0
"Dec 31, 2019",2019,Reagan,25000000,0,0,0
"Nov 9, 2012",2012,Dangerous Liaisons,24200000,17000,10430579,10447579
"Nov 26, 1986",1986,Star Trek IV: The Voyage Home,24000000,109713132,23286868,133000000
"Dec 12, 1997",1997,Scream 2,24000000,101363301,71000000,172363301
"Feb 21, 2003",2003,Old School,24000000,75155000,11610463,86765463
"Dec 20, 2006",2006,Rocky Balboa,24000000,70269899,85959151,156229050
"Jun 20, 2014",2014,Think Like a Man Too,24000000,65028687,4999246,70027933
"Dec 16, 2016",2016,Fences,24000000,57682904,6599977,64282881
"Feb 18, 2000",2000,The Whole Nine Yards,24000000,57262492,28265375,85527867
"Oct 14, 2011",2011,Footloose,24000000,51802742,11187092,62989834
"Apr 7, 2017",2017,Going in Style,24000000,45018541,33654038,78672579
"Jul 12, 1991",1991,Point Break,24000000,43218387,40313571,83531958
"Sep 20, 1991",1991,The Fisher King,24000000,41798224,0,41798224
"Nov 13, 1998",1998,I Still Know What You Did Last Summer,24000000,40020622,0,40020622
"Nov 21, 2007",2007,Hitman,24000000,39687694,59447877,99135571
"Dec 16, 1969",1969,"Hello, Dolly",24000000,33208099,0,33208099
"Apr 7, 2000",2000,Return to Me,24000000,32662299,0,32662299
"Nov 6, 2009",2009,The Men Who Stare at Goats,24000000,32428195,34920023,67348218
"Oct 31, 2008",2008,Zack and Miri Make a Porno,24000000,31457946,5398360,36856306
"Jan 12, 2001",2001,Double Take,24000000,29823162,0,29823162
"Dec 21, 1999",1999,"Girl, Interrupted",24000000,28871190,0,28871190
"Sep 8, 2000",2000,Nurse Betty,24000000,25170054,2562312,27732366
"Aug 20, 2010",2010,Piranha 3D,24000000,25003155,58657005,83660160
"Nov 24, 2010",2010,Faster,24000000,23240020,12552925,35792945
"Oct 24, 1978",1978,The Wiz,24000000,22000000,0,22000000
"Jan 23, 2004",2004,Win a Date with Tad Hamilton!,24000000,16980098,0,16980098
"Jul 14, 1999",1999,Muppets From Space,24000000,16304786,0,16304786
"Apr 7, 2000",2000,Ready to Rumble,24000000,12372410,0,12372410
"Sep 16, 2011",2011,I Don't Know How She Does It,24000000,9659074,14815389,24474463
"Dec 24, 1999",1999,Play it to the Bone,24000000,8427204,0,8427204
"Dec 20, 2013",2013,Dhoom 3,24000000,8031955,3691665,11723620
"Dec 17, 2004",2004,Beyond the Sea,24000000,6144806,2148108,8292914
"Jun 10, 2005",2005,Hauru no ugoku shiro,24000000,4710455,233103872,237814327
"Mar 27, 1998",1998,Meet the Deedles,24000000,4356126,0,4356126
"Aug 25, 1995",1995,The Thief and the Cobbler,24000000,669276,0,669276
"Jun 10, 2005",2005,The Bridge of San Luis Rey,24000000,49981,1646784,1696765
"Dec 31, 2007",2007,Flood,24000000,0,4084232,4084232
"Oct 2, 2009",2009,Zombieland,23600000,75590286,26646310,102236596
"May 21, 1980",1980,Star Wars Ep. V: The Empire Strikes Back,23000000,290271960,243889374,534161334
"Nov 6, 1998",1998,The Waterboy,23000000,161491646,28700000,190191646
"Jun 28, 1991",1991,The Naked Gun 2Â½: The Smell of Fear,23000000,86930411,0,86930411
"Nov 16, 2018",2018,Green Book,23000000,85080171,236954268,322034439
"Apr 7, 1995",1995,Bad Boys,23000000,65647413,75600000,141247413
"Jan 16, 2015",2015,The Wedding Ringer,23000000,64460211,15711385,80171596
"Mar 17, 2000",2000,Final Destination,23000000,53302314,58734556,112036870
"Dec 17, 1976",1976,King Kong,23000000,52614445,38000000,90614445
"Oct 7, 2011",2011,The Ides of March,23000000,40962534,36773391,77735925
"Feb 18, 2000",2000,Pitch Black,23000000,39235088,13947000,53182088
"Oct 5, 2018",2018,The Hate U Give,23000000,29719483,5348182,35067665
"Mar 30, 2001",2001,Someone Like You,23000000,27338033,11346873,38684906
"Jan 10, 2014",2014,Her,23000000,25568251,22595564,48163815
"Oct 5, 2001",2001,Joy Ride,23000000,21973182,0,21973182
"Feb 17, 2012",2012,Kari gurashi no Arietti,23000000,19192510,132303587,151496097
"Jan 20, 2012",2012,Haywire,23000000,18942396,17432304,36374700
"Nov 12, 1999",1999,Anywhere But Here,23000000,18653615,0,18653615
"Sep 1, 2004",2004,Vanity Fair,23000000,16123851,3000000,19123851
"Feb 26, 2016",2016,Eddie the Eagle,23000000,15789389,29271091,45060480
"Jul 17, 1987",1987,Jaws 4: The Revenge,23000000,15728335,0,15728335
"Aug 25, 2000",2000,The Crew,23000000,13019253,0,13019253
"Dec 20, 1996",1996,Marvin's Room,23000000,12803305,0,12803305
"Jan 9, 2004",2004,Chasing Liberty,23000000,12189514,102461,12291975
"Aug 22, 2008",2008,The Longshots,23000000,11511323,267073,11778396
"Dec 3, 1999",1999,The End of the Affair,23000000,10660147,0,10660147
"Aug 23, 1991",1991,Harley Davidson and the Marlboro Man,23000000,7018525,0,7018525
"Sep 14, 2007",2007,In the Valley of Elah,23000000,6777741,17711409,24489150
"Sep 25, 2009",2009,Coco avant Chanel,23000000,6113834,44700000,50813834
"Jun 26, 2009",2009,ChÃ©ri,23000000,2715657,0,2715657
"Jun 28, 2013",2013,Redemption,23000000,36686,13556787,13593473
"Apr 25, 2008",2008,Rogue,23000000,10452,4662925,4673377
"May 5, 2017",2017,ChÄi dÃ n zhuÄnjiÄ,23000000,0,58807172,58807172
"Mar 15, 2011",2011,Shi Yue Wei Cheng,23000000,0,44195779,44195779
"Jun 24, 1987",1987,Spaceballs,22700000,38119483,0,38119483
"Jun 22, 2007",2007,1408,22500000,71985628,59277742,131263370
"Nov 18, 2016",2016,Nocturnal Animals,22500000,10663357,21735324,32398681
"Apr 24, 2015",2015,The Water Diviner,22500000,4200117,26854610,31054727
"Jul 13, 1990",1990,Ghost,22000000,217631306,299968694,517600000
"Jul 15, 1998",1998,There's Something About Mary,22000000,176484651,193400000,369884651
"Nov 11, 1994",1994,The Santa Clause,22000000,144833357,44966643,189800000
"Sep 28, 2007",2007,The Game Plan,22000000,90648202,55942785,146590987
"Mar 29, 2002",2002,The Rookie,22000000,75600072,4891444,80491516
"Jun 2, 1995",1995,The Bridges of Madison County,22000000,71516617,104000000,175516617
"Feb 28, 2014",2014,Son of God,22000000,59700064,11249729,70949793
"Jun 1, 2001",2001,The Animal,22000000,55762229,0,55762229
"Aug 8, 2014",2014,The Hundred-Foot Journey,22000000,54235441,40035047,94270488
"Dec 8, 1982",1982,Gandhi,22000000,52767889,75000000,127767889
"Sep 19, 2003",2003,Underworld,22000000,51970690,43737767,95708457
"Jul 28, 1995",1995,The Net,22000000,50621733,59900000,110521733
"Aug 3, 2012",2012,Diary of a Wimpy Kid: Dog Days,22000000,49008662,28221033,77229695
"Dec 28, 2001",2001,I Am Sam,22000000,40270895,52271523,92542418
"Nov 11, 2005",2005,Derailed,22000000,36020063,21500000,57520063
"Sep 18, 2009",2009,The Informant!,22000000,33316821,8454347,41771168
"Nov 22, 2013",2013,Delivery Man,22000000,30659817,39877053,70536870
"Feb 5, 2016",2016,"Hail, Caesar!",22000000,30080225,34080455,64160680
"Aug 24, 2001",2001,Jay and Silent Bob Strike Back,22000000,30059386,3703014,33762400
"Dec 29, 1993",1993,Shadowlands,22000000,25842377,0,25842377
"Aug 27, 2008",2008,Traitor,22000000,23530831,4351395,27882226
"Aug 12, 2005",2005,Deuce Bigalow: European Gigolo,22000000,22400154,22873310,45273464
"May 19, 2017",2017,Diary of a Wimpy Kid: The Long Haul,22000000,20738724,14870853,35609577
"Jan 18, 2008",2008,Mad Money,22000000,20668843,4375214,25044057
"Nov 27, 2013",2013,Homefront,22000000,20158492,31536870,51695362
"Sep 19, 2008",2008,Igor,22000000,19528602,11484747,31013349
"Feb 9, 2001",2001,Saving Silverman,22000000,19351569,6521573,25873142
"Jul 2, 1999",1999,Summer of Sam,22000000,19288130,0,19288130
"Sep 14, 2001",2001,The Glass House,22000000,17951431,4910354,22861785
"Sep 4, 2015",2015,The Transporter Refueled,22000000,16029670,53668825,69698495
"Jun 13, 1980",1980,The Island,22000000,15716828,0,15716828
"Apr 11, 2001",2001,Josie and the Pussycats,22000000,14252830,0,14252830
"Aug 22, 2012",2012,Hit & Run,22000000,13749300,3467655,17216955
"Oct 27, 2000",2000,The Little Vampire,22000000,13555988,0,13555988
"Oct 1, 2004",2004,I Heart Huckabees,22000000,12784713,7250000,20034713
"Nov 17, 2017",2017,"Roman J. Israel, Esq.",22000000,11962712,1004300,12967012
"Dec 4, 2013",2013,Out of the Furnace,22000000,11330849,4103526,15434375
"Nov 5, 1993",1993,RoboCop 3,22000000,10696210,0,10696210
"Aug 27, 1999",1999,Dudley Do-Right,22000000,9818792,0,9818792
"Dec 8, 2017",2017,Just Getting Started,22000000,6069605,686807,6756412
"Sep 21, 2001",2001,Megiddo: Omega Code 2,22000000,6047691,0,6047691
"Jan 1, 1970",1970,Darling Lili,22000000,5000000,0,5000000
"Nov 23, 2005",2005,The Libertine,22000000,4835065,4613558,9448623
"Apr 6, 2007",2007,Zwartboek,22000000,4398532,22839822,27238354
"Oct 31, 2014",2014,Before I Go to Sleep,22000000,3242457,16321122,19563579
"Oct 8, 2010",2010,Stone,22000000,1810078,2254942,4065020
"Mar 3, 2006",2006,Joyeux NoÃ«l,22000000,1054361,22079714,23134075
"Dec 31, 2013",2013,Metegol,22000000,0,34061097,34061097
"Jun 24, 1977",1977,Sorcerer,21600000,12000000,5968,12005968
"Jul 27, 2007",2007,MoliÃ¨re,21600000,635733,155421,791154
"Oct 5, 2007",2007,Michael Clayton,21500000,49033882,43953769,92987651
"Jul 9, 1999",1999,Arlington Road,21500000,24419219,0,24419219
"Dec 20, 1996",1996,My Fellow Americans,21500000,22331846,0,22331846
"Jun 22, 2012",2012,To Rome with Love,21500000,16684352,57641663,74326015
"Nov 16, 2012",2012,Silver Linings Playbook,21000000,132092958,104319495,236412453
"Apr 6, 2018",2018,Blockers,21000000,60311495,33733833,94045328
"Apr 5, 2019",2019,Pet Sematary,21000000,54724696,54776450,109501146
"Jun 30, 1999",1999,"South Park: Bigger, Longer & Uncut",21000000,52037603,0,52037603
"Jun 18, 1982",1982,Firefox,21000000,45785720,0,45785720
"Apr 16, 2010",2010,Death at a Funeral,21000000,42739347,6237886,48977233
"Mar 19, 1993",1993,Teenage Mutant Ninja Turtles III,21000000,42273609,0,42273609
"Sep 14, 2001",2001,Hardball,21000000,40222729,3505831,43728560
"Nov 5, 2010",2010,For Colored Girls,21000000,37729698,288175,38017873
"Jan 5, 2007",2007,Freedom Writers,21000000,36605602,7027007,43632609
"Aug 4, 2017",2017,Kidnap,21000000,30718107,4117973,34836080
"Oct 11, 2002",2002,The Transporter,21000000,25296447,18632485,43928932
"Mar 14, 2008",2008,Never Back Down,21000000,24850922,14468879,39319801
"Dec 9, 2011",2011,Tinker Tailor Soldier Spy,21000000,24149393,57303418,81452811
"Sep 22, 2017",2017,Victoria and Abdul,21000000,22245070,46026076,68271146
"Nov 5, 1999",1999,The Bachelor,21000000,21731001,15151377,36882378
"Mar 12, 1999",1999,The Rage: Carrie 2,21000000,17760244,0,17760244
"Aug 1, 2008",2008,Swing Vote,21000000,16289867,1300000,17589867
"Jun 5, 2009",2009,Away We Go,21000000,9451946,656070,10108016
"Sep 27, 2002",2002,Moonlight Mile,21000000,6830957,0,6830957
"May 6, 2011",2011,The Beaver,21000000,970816,4075222,5046038
"Feb 24, 2017",2017,Bitter Harvest,21000000,557241,48921,606162
"Oct 22, 1999",1999,Molly,21000000,17396,0,17396
"Feb 1, 2019",2019,Velvet Buzzsaw,21000000,0,0,0
"Apr 23, 1999",1999,eXistenZ,20700000,2840417,0,2840417
"Jul 23, 1982",1982,The Best Little Whorehouse in Texas,20500000,69701637,0,69701637
"Aug 11, 2006",2006,Pulse,20500000,20264436,9976999,30241435
"Nov 13, 1991",1991,Beauty and the Beast,20000000,376057266,232373866,608431132
"Jun 12, 1981",1981,Raiders of the Lost Ark,20000000,225686079,141766000,367452079
"Mar 22, 2019",2019,Us,20000000,175006930,79203380,254210310
"Nov 20, 1992",1992,Home Alone 2: Lost in New York,20000000,173585516,185409334,358994850
"Nov 16, 1977",1977,Close Encounters of the Third Kind,20000000,169100479,171700000,340800479
"May 20, 1987",1987,Beverly Hills Cop II,20000000,153665036,123000000,276665036
"Dec 9, 2016",2016,La La Land,20000000,151101803,275249360,426351163
"Jul 19, 2013",2013,The Conjuring,20000000,137400141,180600000,318000141
"Mar 7, 2003",2003,Bringing Down the House,20000000,132675402,32000000,164675402
"Nov 17, 2017",2017,Wonder,20000000,132422809,172181903,304604712
"Feb 14, 1991",1991,The Silence of the Lambs,20000000,130726716,145000000,275726716
"Feb 14, 1992",1992,Wayne's World,20000000,121697323,61400000,183097323
"Oct 15, 2010",2010,Jackass 3D,20000000,117229692,54456101,171685793
"Jul 29, 2016",2016,Bad Moms,20000000,113257297,67741419,180998716
"Jan 18, 2019",2019,Glass,20000000,111035005,134268500,245303505
"Jun 16, 1978",1978,Jaws 2,20000000,102922376,105978000,208900376
"Oct 3, 2008",2008,Beverly Hills Chihuahua,20000000,94514402,59703766,154218168
"Jul 2, 2014",2014,Tammy,20000000,84525432,11882223,96407655
"Jan 21, 2005",2005,Are We There Yet?,20000000,82674398,15440073,98114471
"Nov 16, 2011",2011,The Descendants,20000000,82624961,92882839,175507800
"Oct 3, 2003",2003,School of Rock,20000000,81261177,50683495,131944672
"Apr 13, 2007",2007,Disturbia,20000000,80818974,37718653,118537627
"Jul 16, 1993",1993,Free Willy,20000000,77698625,76000000,153698625
"Oct 21, 2016",2016,Tyler Perryâs Boo! A Madea Halloween,20000000,73206343,0,73206343
"Aug 18, 1995",1995,Mortal Kombat,20000000,70433227,51700000,122133227
"Jun 23, 2004",2004,White Chicks,20000000,69148997,42300000,111448997
"Apr 24, 2009",2009,Obsessed,20000000,68261644,5703069,73964713
"Apr 18, 2003",2003,Holes,20000000,67383924,3848290,71232214
"Jun 29, 2012",2012,Tyler Perry's Madea's Witness Protection,20000000,65653242,1297645,66950887
"Mar 31, 2010",2010,The Last Song,20000000,62950384,29728564,92678948
"Apr 2, 2010",2010,Why Did I Get Married Too?,20000000,60095852,735215,60831067
"Oct 23, 1998",1998,La vita Ã¨ bella,20000000,57598247,171787114,229385361
"Oct 18, 2013",2013,12 Years a Slave,20000000,56671993,124353350,181025343
"Dec 13, 2002",2002,Drumline,20000000,56398162,0,56398162
"Jun 3, 2016",2016,Me Before You,20000000,56245075,152020123,208265198
"Feb 8, 2019",2019,What Men Want,20000000,54611903,15300000,69911903
"Apr 15, 2016",2016,Barbershop: The Next Cut,20000000,54030051,374151,54404202
"Dec 7, 1990",1990,Edward Scissorhands,20000000,53976987,0,53976987
"Sep 14, 2018",2018,A Simple Favor,20000000,53548586,44080131,97628717
"Jan 9, 2015",2015,Selma,20000000,52076908,14699668,66776576
"Dec 12, 1980",1980,Popeye,20000000,49823037,0,49823037
"Feb 17, 2006",2006,Date Movie,20000000,48548426,36597739,85146165
"Feb 15, 2002",2002,Peter Pan: Return to Neverland,20000000,48430258,61432424,109862682
"Feb 14, 2003",2003,The Jungle Book 2,20000000,47901582,92220643,140122225
"Mar 16, 2007",2007,Premonition,20000000,47852604,33608739,81461343
"Oct 20, 2017",2017,Tyler Perryâs Boo 2! A Madea Halloween,20000000,47319572,560000,47879572
"Feb 4, 2005",2005,Boogeyman,20000000,46752382,20440477,67192859
"Feb 11, 2000",2000,The Tigger Movie,20000000,45542421,50605267,96147688
"Nov 6, 2015",2015,Spotlight,20000000,45055776,47032684,92088460
"Mar 30, 2018",2018,Acrimony,20000000,43549096,3078740,46627836
"Jun 26, 2015",2015,Max,20000000,42656255,1001902,43658157
"Mar 21, 2008",2008,Meet the Browns,20000000,41975388,0,41975388
"Jul 24, 2009",2009,Orphan,20000000,41596251,37173177,78769428
"Nov 17, 2017",2017,The Star,20000000,40847995,21910015,62758010
"Jan 26, 2007",2007,Epic Movie,20000000,39739367,47119211,86858578
"Sep 19, 2008",2008,Lakeview Terrace,20000000,39263506,5557793,44821299
"Oct 13, 2006",2006,The Grudge 2,20000000,39143839,31600000,70743839
"Jul 27, 2016",2016,Nerve,20000000,38583626,32068658,70652284
"May 14, 1982",1982,Conan the Barbarian,20000000,38264085,40850000,79114085
"Aug 14, 1998",1998,How Stella Got Her Groove Back,20000000,37672944,0,37672944
"Jul 19, 1991",1991,Bill & Ted's Bogus Journey,20000000,37537675,0,37537675
"Oct 13, 2006",2006,Man of the Year,20000000,37442180,3900000,41342180
"Feb 19, 2016",2016,Risen,20000000,36880033,9375730,46255763
"Aug 18, 2010",2010,Vampires Suck,20000000,36661504,44763484,81424988
"Dec 21, 1979",1979,The Black Hole,20000000,35841901,0,35841901
"Sep 1, 2010",2010,The American,20000000,35606376,32344347,67950723
"Mar 21, 1997",1997,Selena,20000000,35450113,0,35450113
"Nov 4, 2011",2011,A Very Harold & Kumar 3D Christmas,20000000,35061031,1204714,36265745
"Mar 19, 2004",2004,Eternal Sunshine of the Spotless Mind,20000000,34366518,38204244,72570762
"Jan 4, 2013",2013,Texas Chainsaw 3D,20000000,34341945,13324068,47666013
"Oct 27, 2006",2006,Babel,20000000,34302837,97818375,132121212
"Sep 19, 2014",2014,This is Where I Leave You,20000000,34296320,7000000,41296320
"Dec 12, 2008",2008,Doubt,20000000,33446470,19744631,53191101
"Oct 15, 2004",2004,Team America: World Police,20000000,32774834,18173977,50948811
"Oct 27, 1995",1995,Copycat,20000000,32051917,0,32051917
"Apr 12, 2013",2013,Scary Movie V,20000000,32015787,46598194,78613981
"Mar 12, 2010",2010,She's Out of My League,20000000,32010860,16670117,48680977
"Nov 26, 2008",2008,Milk,20000000,31841299,25452072,57293371
"Oct 15, 1969",1969,Paint Your Wagon,20000000,31678778,0,31678778
"Aug 31, 2011",2011,The Debt,20000000,31177548,15426506,46604054
"Oct 25, 2002",2002,Ghost Ship,20000000,30113491,38236393,68349884
"Jan 8, 2010",2010,Daybreakers,20000000,30101577,21343926,51445503
"Mar 7, 2008",2008,The Bank Job,20000000,30060660,36082345,66143005
"Mar 20, 1998",1998,Wild Things,20000000,29795299,25781400,55576699
"Oct 16, 2009",2009,The Stepfather,20000000,29062561,165000,29227561
"Mar 31, 2000",2000,High Fidelity,20000000,27277055,20604608,47881663
"Apr 28, 2006",2006,Stick It,20000000,26910736,3488978,30399714
"Jan 4, 2008",2008,One Missed Call,20000000,26890041,17623425,44513466
"Jan 12, 1996",1996,Eye for an Eye,20000000,26792700,0,26792700
"Apr 11, 2008",2008,Street Kings,20000000,26418667,39039144,65457811
"Aug 23, 2013",2013,The World's End,20000000,26004851,21503654,47508505
"Jan 19, 1996",1996,From Dusk Till Dawn,20000000,25728961,4025,25732986
"Sep 24, 2010",2010,You Again,20000000,25702053,7136892,32838945
"Jun 15, 2007",2007,Nancy Drew,20000000,25584685,5119160,30703845
"Sep 17, 2010",2010,Alpha and Omega 3D,20000000,25107267,23851086,48958353
"Dec 25, 2018",2018,On the Basis of Sex,20000000,24622687,13450690,38073377
"Feb 14, 2014",2014,Endless Love,20000000,23438250,11279923,34718173
"Sep 8, 2006",2006,The Covenant,20000000,23364784,14800000,38164784
"Jul 1, 2011",2011,Monte Carlo,20000000,23186769,16500000,39686769
"Mar 24, 2006",2006,Stay Alive,20000000,23086480,101026,23187506
"Oct 7, 2005",2005,2 For the Money,20000000,22991379,7500000,30491379
"Jun 16, 2017",2017,Rough Night,20000000,22105643,24738714,46844357
"Dec 4, 1998",1998,Psycho,20000000,21541218,15685000,37226218
"Oct 19, 1990",1990,Quigley Down Under,20000000,21413105,0,21413105
"Sep 27, 1995",1995,To Die For,20000000,21284514,6404230,27688744
"Aug 21, 2009",2009,Shorts,20000000,20919166,8951635,29870801
"Oct 30, 1998",1998,Vampires,20000000,20268825,0,20268825
"Sep 19, 2008",2008,Appaloosa,20000000,20211394,7700059,27911453
"Nov 20, 2015",2015,Secret in Their Eyes,20000000,20180155,12427864,32608019
"Aug 13, 2004",2004,Yu-Gi-Oh,20000000,19762690,9000000,28762690
"Mar 23, 2007",2007,Reign Over Me,20000000,19661987,420000,20081987
"Sep 19, 2008",2008,My Best Friend's Girl,20000000,19219250,15567861,34787111
"May 11, 2007",2007,Georgia Rule,20000000,18882880,1936721,20819601
"Jul 31, 1981",1981,Under the Rainbow,20000000,18826490,0,18826490
"Apr 12, 1985",1985,Ladyhawke,20000000,18400000,0,18400000
"Sep 21, 2007",2007,Into the Wild,20000000,18354356,38468604,56822960
"Sep 11, 1998",1998,Simon Birch,20000000,18253415,57176,18310591
"Feb 11, 2005",2005,Pooh's Heffalump Movie,20000000,18098433,37588511,55686944
"Sep 29, 2006",2006,School for Scoundrels,20000000,17807569,0,17807569
"Oct 26, 2012",2012,Silent Hill: Revelation 3D,20000000,17530219,38445453,55975672
"Nov 3, 1995",1995,Home for the Holidays,20000000,17468887,4650382,22119269
"Mar 31, 2017",2017,The Zookeeperâs Wife,20000000,17445186,8863563,26308749
"Feb 20, 2009",2009,Fired Up,20000000,17231291,1377279,18608570
"Apr 8, 2005",2005,Kung Fu Hustle,20000000,17104669,84929435,102034104
"Jul 26, 2002",2002,The Country Bears,20000000,16988996,0,16988996
"Sep 29, 2017",2017,Flatliners,20000000,16883115,28290623,45173738
"Mar 16, 2007",2007,Dead Silence,20000000,16574590,4040071,20614661
"Nov 21, 2003",2003,21 Grams,20000000,16248701,43418924,59667625
"Dec 4, 2009",2009,Armored,20000000,15988876,7672162,23661038
"Dec 14, 2007",2007,The Kite Runner,20000000,15800078,58380667,74180745
"Sep 3, 2004",2004,Paparazzi,20000000,15712072,900000,16612072
"Jan 17, 2003",2003,A Guy Thing,20000000,15543862,1886732,17430594
"Feb 15, 1965",1965,The Greatest Story Ever Told,20000000,15473333,0,15473333
"Jul 21, 2000",2000,Loser,20000000,15464026,2786080,18250106
"Mar 6, 1998",1998,Twilight,20000000,15055091,0,15055091
"Sep 23, 2009",2009,Capitalism: A Love Story,20000000,14363397,4758134,19121531
"Apr 13, 2012",2012,Lockout,20000000,14326865,19616184,33943049
"Aug 29, 2008",2008,Disaster Movie,20000000,14190901,22529851,36720752
"Sep 30, 2011",2011,What's Your Number?,20000000,14011084,16152701,30163785
"Nov 14, 1997",1997,The Man Who Knew Too Little,20000000,13801755,0,13801755
"Apr 17, 2009",2009,Crank 2: High Voltage,20000000,13684249,21788490,35472739
"Oct 30, 2015",2015,Burnt,20000000,13651946,23121564,36773510
"Apr 30, 2004",2004,Envy,20000000,13548322,1017924,14566246
"Oct 13, 2006",2006,One Night with the King,20000000,13395961,329071,13725032
"Oct 21, 1994",1994,Bullets Over Broadway,20000000,13383747,0,13383747
"Sep 19, 2008",2008,Ghost Town,20000000,13367624,16590604,29958228
"Nov 22, 2002",2002,The Quiet American,20000000,12987647,13360556,26348203
"Feb 26, 2016",2016,Triple 9,20000000,12639297,13304495,25943792
"Sep 2, 2016",2016,The Light Between Oceans,20000000,12545979,9735753,22281732
"Oct 28, 2005",2005,The Weather Man,20000000,12482775,2984186,15466961
"Aug 23, 2002",2002,Undisputed,20000000,12398628,0,12398628
"Mar 27, 2009",2009,12 Rounds,20000000,12234694,5071954,17306648
"Oct 1, 2010",2010,Let Me In,20000000,12134935,16135464,28270399
"May 6, 1994",1994,3 Ninjas Kick Back,20000000,11744960,0,11744960
"Feb 22, 2008",2008,Be Kind Rewind,20000000,11175164,19719083,30894247
"Dec 9, 2005",2005,Mrs. Henderson Presents,20000000,11036366,16800000,27836366
"Dec 12, 1997",1997,Deconstructing Harry,20000000,10686841,0,10686841
"Oct 22, 1999",1999,Three to Tango,20000000,10570375,0,10570375
"Dec 15, 1989",1989,We're No Angels,20000000,10555348,0,10555348
"Dec 6, 1996",1996,Everyone Says I Love You,20000000,9725847,24874153,34600000
"Aug 31, 2007",2007,Death Sentence,20000000,9534258,7373573,16907831
"Jun 3, 2016",2016,Popstar: Never Stop Never Stopping,20000000,9496130,40990,9537120
"Oct 27, 2017",2017,Thank You for Your Service,20000000,9479390,505926,9985316
"Dec 4, 2009",2009,Everybody's Fine,20000000,9208876,0,9208876
"Aug 27, 2004",2004,Superbabies: Baby Geniuses 2,20000000,9109322,246047,9355369
"Sep 20, 2013",2013,Battle of the Year,20000000,8888355,7835022,16723377
"Apr 29, 2016",2016,Ratchet and Clank,20000000,8813410,5552229,14365639
"Aug 17, 2007",2007,Death at a Funeral,20000000,8580428,38210000,46790428
"Sep 9, 2005",2005,The Man,20000000,8330720,2062976,10393696
"Jan 5, 2007",2007,Code Name: The Cleaner,20000000,8135024,0,8135024
"Dec 12, 2014",2014,Inherent Vice,20000000,8110975,6661371,14772346
"Apr 16, 2004",2004,Connie & Carla,20000000,8047525,0,8047525
"Oct 11, 2013",2013,Machete Kills,20000000,8008161,10264848,18273009
"Jan 1, 1969",1969,Sweet Charity,20000000,8000000,0,8000000
"Feb 24, 2006",2006,Doogal,20000000,7578946,20479706,28058652
"Sep 16, 2005",2005,Proof,20000000,7535331,749000,8284331
"Oct 3, 2008",2008,An American Carol,20000000,7013191,8992,7022183
"Mar 14, 2003",2003,Willard,20000000,6882696,0,6882696
"Feb 1, 2008",2008,Strange Wilderness,20000000,6575282,371802,6947084
"Apr 24, 2015",2015,Little Boy,20000000,6485961,11283338,17769299
"Dec 17, 1999",1999,Topsy Turvy,20000000,6201757,0,6201757
"Oct 26, 2012",2012,Chasing Mavericks,20000000,6002756,2298065,8300821
"Dec 31, 2014",2014,A Most Violent Year,20000000,5749134,3097741,8846875
"Nov 23, 2011",2011,A Dangerous Method,20000000,5702083,9105448,14807531
"Jul 7, 2006",2006,A Scanner Darkly,20000000,5501616,1903468,7405084
"Aug 14, 2009",2009,Bandslam,20000000,5210988,7756841,12967829
"Jan 28, 2005",2005,Alone in the Dark,20000000,5178569,5409510,10588079
"Oct 29, 2004",2004,Birth,20000000,5005899,9597102,14603001
"Aug 26, 2016",2016,Hands of Stone,20000000,4712792,319183,5031975
"Oct 24, 2008",2008,Passchendaele,20000000,4452423,904,4453327
"Oct 3, 2008",2008,Flash of Genius,20000000,4442377,61734,4504111
"Nov 21, 2007",2007,Iâm Not There,20000000,4017609,8380004,12397613
"Sep 7, 2012",2012,The Cold Light of Day,20000000,3763583,21597623,25361206
"May 15, 2009",2009,The Brothers Bloom,20000000,3531756,2000000,5531756
"Oct 24, 2008",2008,"Synecdoche, New York",20000000,3083538,1300000,4383538
"Oct 26, 2018",2018,Suspiria,20000000,2483472,4551143,7034615
"Nov 3, 2017",2017,LBJ,20000000,2468683,38498,2507181
"Oct 29, 1999",1999,Mononoke-hime,20000000,2374107,147975893,150350000
"Mar 19, 2004",2004,Bon Voyage,20000000,2353728,6008008,8361736
"Nov 13, 2015",2015,My All-American,20000000,2246000,0,2246000
"Jun 20, 1980",1980,Can't Stop the Music,20000000,2000000,0,2000000
"May 5, 2006",2006,The Proposition,20000000,1903434,3410174,5313608
"Aug 22, 2003",2003,Marci X,20000000,1646664,0,1646664
"Dec 6, 2002",2002,Equilibrium,20000000,1190018,4155851,5345869
"Apr 29, 2011",2011,Dylan Dog: Dead of Night,20000000,1186538,4907187,6093725
"Aug 29, 2012",2012,The Oogieloves in the BIG Balloon Adventure,20000000,1065907,0,1065907
"May 23, 2008",2008,The Children of Huang Shi,20000000,1031872,7189828,8221700
"Oct 20, 2000",2000,The Yards,20000000,882710,1400000,2282710
"Aug 6, 2010",2010,Middle Men,20000000,754301,0,754301
"Apr 28, 2017",2017,JÃ¬yÃ¬ dÃ shÄ«,20000000,587470,43301061,43888531
"Dec 3, 2010",2010,All Good Things,20000000,582024,291593,873617
"Nov 13, 2015",2015,By the Sea,20000000,538460,3189286,3727746
"Mar 18, 2005",2005,Steamboy,20000000,468867,10000000,10468867
"Apr 22, 2005",2005,The Game of Their Lives,20000000,375474,0,375474
"Sep 11, 1994",1994,Rapa Nui,20000000,305070,0,305070
"Dec 10, 2010",2010,The Tempest,20000000,277943,0,277943
"Mar 7, 2008",2008,é·æ±ä¸è (CJ7),20000000,206678,47094093,47300771
"Sep 18, 2009",2009,The Burning Plain,20000000,200730,966362,1167092
"Mar 27, 1998",1998,Les Couloirs du temps: Les visiteurs 2,20000000,146072,26000000,26146072
"Apr 25, 2003",2003,People I Know,20000000,121972,5572241,5694213
"Oct 30, 2015",2015,Regression,20000000,55039,15769335,15824374
"Dec 31, 2008",2008,Admiral,20000000,0,38585047,38585047
"Dec 31, 2012",2012,Zambezia,20000000,0,34454336,34454336
"Apr 13, 2010",2010,Three Kingdoms: Resurrection of the Dragon,20000000,0,22139590,22139590
"Mar 31, 2004",2004,The Touch,20000000,0,5918742,5918742
"May 29, 2015",2015,Survivor,20000000,0,1703281,1703281
"Nov 18, 2016",2016,The History of Love,20000000,0,476624,476624
"Dec 25, 2007",2007,Butterfly on a Wheel,20000000,0,0,0
"Aug 29, 2014",2014,Dwegons and Leprechauns,20000000,0,0,0
"Jul 22, 2016",2016,Fight Valley,20000000,0,0,0
"Dec 31, 2017",2017,The Thousand Miles,20000000,0,0,0
"Dec 13, 2018",2018,Bird Box,19800000,0,0,0
"Aug 21, 2009",2009,Der Baader Meinhof Komplex,19700000,476270,16022557,16498827
"Dec 1, 2017",2017,The Shape of Water,19500000,63859435,131931359,195790794
"Nov 23, 2012",2012,De rouille et dâos,19500000,2061449,27332185,29393634
"Dec 20, 2006",2006,The Painted Veil,19400000,8060487,7058308,15118795
"Aug 23, 2013",2013,The Frozen Ground,19200000,0,5617460,5617460
"Jul 29, 2011",2011,The Devil's Double,19100000,1361512,4604134,5965646
"Jul 3, 1985",1985,Back to the Future,19000000,212259762,173265022,385524784
"Nov 9, 1990",1990,Dances with Wolves,19000000,184208842,239991158,424200000
"Jul 7, 2000",2000,Scary Movie,19000000,157019771,120180229,277200000
"Jun 24, 2011",2011,Bad Teacher,19000000,100292856,115156141,215448997
"Aug 12, 2016",2016,Sausage Party,19000000,97670358,43673897,141344255
"Sep 15, 1989",1989,Sea of Love,19000000,58571513,0,58571513
"Jan 10, 2003",2003,Just Married,19000000,56127162,45437773,101564935
"Sep 11, 2009",2009,I Can Do Bad All By Myself,19000000,51733921,0,51733921
"Jul 16, 2004",2004,A Cinderella Story,19000000,51438175,18725930,70164105
"May 23, 1980",1980,The Shining,19000000,44017374,710853,44728227
"Oct 26, 2001",2001,Thirteen Ghosts,19000000,41867960,26600000,68467960
"Oct 29, 1999",1999,House on Haunted Hill,19000000,40846082,24244459,65090541
"Feb 26, 2010",2010,The Crazies,19000000,39123589,17321945,56445534
"Jan 16, 2009",2009,Notorious,19000000,36843682,8128501,44972183
"Nov 2, 2018",2018,Nobodyâs Fool,19000000,31713110,876383,32589493
"Aug 20, 2010",2010,The Switch,19000000,27758465,22100000,49858465
"Jan 8, 2010",2010,Leap Year,19000000,25918920,6700000,32618920
"Nov 8, 2013",2013,The Book Thief,19000000,21488481,54598230,76086711
"Oct 19, 2007",2007,"Gone, Baby, Gone",19000000,20300218,14051944,34352162
"Jul 26, 2000",2000,Thomas and the Magic Railroad,19000000,15911332,0,15911332
"Nov 8, 1962",1962,Mutiny on The Bounty,19000000,13680000,0,13680000
"Sep 20, 2002",2002,Sen to Chihiro no Kamikakushi,19000000,10049886,264900000,274949886
"Oct 17, 2008",2008,Sex Drive,19000000,8402485,2010000,10412485
"Jan 9, 1998",1998,Firestorm,19000000,8123860,0,8123860
"Mar 4, 2011",2011,Take Me Home Tonight,19000000,6928068,648536,7576604
"Sep 28, 2012",2012,Won't Back Down,19000000,5310554,434949,5745503
"Jun 1, 2018",2018,Action Point,19000000,5059608,44067,5103675
"Jan 1, 1964",1964,The Fall of the Roman Empire,19000000,4750000,0,4750000
"Nov 24, 1993",1993,The Nutcracker,19000000,2119994,0,2119994
"Dec 13, 2011",2011,George Balanchine\'s The Nutcracker,19000000,2119994,0,2119994
"Aug 16, 1996",1996,Kansas City,19000000,1353824,0,1353824
"Mar 8, 2016",2016,Out of the Inferno,19000000,0,0,0
"Jun 24, 2005",2005,George A. Romero's Land of the Dead,18975000,20700082,27050933,47751015
"Dec 15, 2006",2006,IndigÃ¨nes,18900000,320700,25742872,26063572
"Apr 15, 2005",2005,The Amityville Horror,18500000,65233369,43942304,109175673
"Dec 6, 2002",2002,Adaptation,18500000,22498520,10033239,32531759
"Oct 2, 2009",2009,The Invention of Lying,18500000,18451251,14228013,32679264
"May 22, 1998",1998,Fear and Loathing in Las Vegas,18500000,10680275,3031628,13711903
"Jul 4, 2008",2008,Ne le dis Ã personne,18500000,6198883,27755135,33954018
"Feb 2, 2001",2001,Left Behind,18500000,4221341,0,4221341
"May 9, 2014",2014,Neighbors,18000000,150086800,120857628,270944428
"Nov 3, 2006",2006,Borat,18000000,128505958,132937284,261443242
"Jul 29, 1994",1994,The Mask,18000000,119920129,231700000,351620129
"Jun 3, 1988",1988,Big,18000000,114968774,36700000,151668774
"Jul 13, 2001",2001,Legally Blonde,18000000,96493426,45315809,141809235
"Apr 30, 2004",2004,Mean Girls,18000000,86047227,44905799,130953026
"Jun 1, 1984",1984,Star Trek III: The Search for Spock,18000000,76471046,10528954,87000000
"Sep 9, 2005",2005,The Exorcism of Emily Rose,18000000,75072454,69456624,144529078
"Dec 10, 1999",1999,Deuce Bigalow: Male Gigolo,18000000,65535067,27400000,92935067
"Jan 1, 2004",2004,Barbershop 2: Back in Business,18000000,65070412,772000,65842412
"Dec 16, 2005",2005,The Family Stone,18000000,60062868,32294631,92357499
"Nov 26, 2003",2003,Bad Santa,18000000,60060328,17086703,77147031
"Jun 12, 1987",1987,Predator,18000000,59735548,38532010,98267558
"Mar 25, 2016",2016,My Big Fat Greek Wedding 2,18000000,59689605,32406953,92096558
"Sep 11, 2015",2015,The Perfect Guy,18000000,57027435,3250731,60278166
"May 2, 1997",1997,Austin Powers: International Man of Mystery,18000000,53883989,13800000,67683989
"Mar 25, 2011",2011,Diary of a Wimpy Kid: Rodrick Rules,18000000,52698535,20996659,73695194
"Sep 19, 1984",1984,Amadeus,18000000,51973029,0,51973029
"Apr 11, 2008",2008,Prom Night,18000000,43869350,13324305,57193655
"Apr 8, 2011",2011,Soul Surfer,18000000,43853424,3305228,47158652
"Sep 26, 2003",2003,Under the Tuscan Sun,18000000,43601508,13888516,57490024
"Jun 29, 2018",2018,Uncle Drew,18000000,42469946,4057215,46527161
"Oct 17, 2014",2014,Birdman or (The Unexpected Virtue of Ignorance),18000000,42340598,60874496,103215094
"Oct 10, 1986",1986,Peggy Sue Got Married,18000000,41382841,0,41382841
"Dec 26, 2001",2001,Gosford Park,18000000,41300105,0,41300105
"Jan 11, 2002",2002,Orange County,18000000,41059716,2248991,43308707
"Jul 26, 2013",2013,Blue Jasmine,18000000,33404871,69508090,102912961
"Apr 28, 2006",2006,United 93,18000000,31567134,46067901,77635035
"Dec 5, 2003",2003,Honey,18000000,30272254,32374509,62646763
"Oct 14, 2005",2005,The Fog,18000000,29511112,7537414,37048526
"May 24, 1996",1996,Spy Hard,18000000,26936265,0,26936265
"Aug 7, 2015",2015,Ricki and the Flash,18000000,26839498,14326535,41166033
"Dec 13, 1989",1989,Glory,18000000,26593580,0,26593580
"Jun 29, 1984",1984,Conan the Destroyer,18000000,26400000,0,26400000
"Nov 13, 2015",2015,Love the Coopers,18000000,26302731,15924759,42227490
"Jun 24, 1970",1970,Catch-22,18000000,24911670,0,24911670
"Apr 10, 2009",2009,Observe and Report,18000000,24007324,3141574,27148898
"Nov 14, 1980",1980,Raging Bull,18000000,23380203,0,23380203
"Sep 18, 2009",2009,Love Happens,18000000,22965110,13167904,36133014
"Sep 25, 2009",2009,Fame,18000000,22455510,57772109,80227619
"Apr 28, 2017",2017,The Circle,18000000,20497844,20154020,40651864
"Dec 4, 1985",1985,Young Sherlock Holmes,18000000,19739000,0,19739000
"Nov 5, 2010",2010,127 Hours,18000000,18335230,41881941,60217171
"May 19, 2000",2000,Small Time Crooks,18000000,17266359,12668118,29934477
"May 12, 2000",2000,Center Stage,18000000,17200925,4160184,21361109
"Jan 15, 2016",2016,Norm of the North,18000000,17062499,13473161,30535660
"Feb 6, 2004",2004,Catch That Kid,18000000,16703799,255815,16959614
"Aug 16, 2013",2013,Jobs,18000000,16131410,27271105,43402515
"Oct 26, 2001",2001,Life as a House,18000000,15652637,8236521,23889158
"Jan 8, 2010",2010,Youth in Revolt,18000000,15285588,4400000,19685588
"Jul 25, 2014",2014,And So It Goes,18000000,15160801,2759212,17920013
"Jul 10, 2009",2009,"I Love You, Beth Cooper",18000000,14800725,1581813,16382538
"Jul 24, 1981",1981,Blow Out,18000000,13747234,0,13747234
"Mar 30, 2001",2001,The Tailor of Panama,18000000,13491653,14000000,27491653
"May 22, 1981",1981,The Legend of the Lone Ranger,18000000,13400000,0,13400000
"Jan 31, 2014",2014,Labor Day,18000000,13371528,818282,14189810
"Aug 30, 2013",2013,Getaway,18000000,10501938,1312051,11813989
"Sep 26, 1997",1997,The Ice Storm,18000000,8038061,7973914,16011975
"Oct 15, 2004",2004,Being Julia,18000000,7739049,6749656,14488705
"Mar 22, 1989",1989,Troop Beverly Hills,18000000,7190505,0,7190505
"Feb 21, 1986",1986,Nine 1/2 Weeks,18000000,6734844,0,6734844
"Jan 15, 2010",2010,The Last Station,18000000,6617867,9078279,15696146
"Jun 26, 1981",1981,Dragonslayer,18000000,6000000,0,6000000
"Sep 30, 1994",1994,Ed Wood,18000000,5828466,0,5828466
"Jun 6, 2008",2008,Mongol,18000000,5705761,21441588,27147349
"Oct 8, 2008",2008,RocknRolla,18000000,5700626,22093713,27794339
"Jun 25, 1982",1982,Megaforce,18000000,5675599,0,5675599
"Aug 20, 2010",2010,Mao's Last Dancer,18000000,4806750,21134687,25941437
"Dec 25, 1996",1996,Hamlet,18000000,4501094,2628576,7129670
"Apr 11, 2014",2014,The Railway Man,18000000,4438438,19471772,23910210
"Dec 29, 1995",1995,Restoration,18000000,4100000,0,4100000
"Mar 18, 2016",2016,Midnight Special,18000000,3712282,3967968,7680250
"Nov 25, 2016",2016,Miss Sloane,18000000,3500605,4219025,7719630
"Sep 27, 2013",2013,Metallica Through the Never,18000000,3419967,5662939,9082906
"Sep 19, 2003",2003,Anything Else,18000000,3203044,10000000,13203044
"Feb 23, 1996",1996,Unforgettable,18000000,2483790,0,2483790
"Mar 17, 2017",2017,T2: Trainspotting,18000000,2402004,39689258,42091262
"Dec 30, 2009",2009,Das Weisse Band: Eine deutsche Kindergeschichte,18000000,2222862,23504182,25727044
"Apr 25, 1986",1986,8 Million Ways to Die,18000000,1305114,0,1305114
"Mar 1, 2013",2013,Phantom,18000000,1034589,164921,1199510
"Apr 26, 2002",2002,The Salton Sea,18000000,676698,0,676698
"Apr 24, 2009",2009,The Informers,18000000,315000,0,315000
"Sep 24, 1999",1999,One Man's Hero,18000000,229311,0,229311
"Oct 15, 2010",2010,Carlos,18000000,145526,1473627,1619153
"Sep 22, 2006",2006,Renaissance,18000000,70644,2330769,2401413
"Dec 31, 2008",2008,I Come with the Rain,18000000,0,627422,627422
"Apr 15, 2016",2016,I Am Wrath,18000000,0,309608,309608
"Nov 14, 2014",2014,Wolves,18000000,0,94953,94953
"Apr 8, 2008",2008,Day of the Dead,18000000,0,0,0
"Aug 22, 2014",2014,The Prince,18000000,0,0,0
"Feb 19, 2016",2016,Forsaken,18000000,0,0,0
"Jun 28, 1985",1985,Red Sonja,17900000,6905861,2779,6908640
"Jul 13, 2012",2012,Red Lights,17700000,49521,14469363,14518884
"Aug 17, 2007",2007,Superbad,17500000,121463226,48491916,169955142
"Feb 20, 2009",2009,Madea Goes To Jail,17500000,90508336,0,90508336
"Feb 14, 2008",2008,Step Up 2 the Streets,17500000,58017783,90569127,148586910
"Jan 13, 2006",2006,Hoodwinked,17500000,51386611,58456779,109843390
"Dec 22, 2004",2004,Hotel Rwanda,17500000,23519128,13002095,36521223
"Aug 25, 2006",2006,Beerfest,17500000,19185184,974132,20159316
"Nov 27, 2013",2013,Black Nativity,17500000,7018188,266947,7285135
"Apr 25, 2003",2003,City of Ghosts,17500000,325491,0,325491
"Dec 31, 2007",2007,Taxi 4,17500000,0,60865364,60865364
"Apr 6, 2018",2018,A Quiet Place,17000000,188024361,146497933,334522294
"Aug 10, 2001",2001,The Others,17000000,96522687,111242369,207765056
"Jul 18, 1986",1986,Aliens,17000000,85160248,98156207,183316455
"Aug 13, 2014",2014,Letâs Be Cops,17000000,82390774,54500000,136890774
"Oct 17, 1997",1997,I Know What You Did Last Summer,17000000,72250091,53000000,125250091
"Oct 22, 1964",1964,My Fair Lady,17000000,72000000,71636,72071636
"Oct 22, 2004",2004,Sideways,17000000,71502303,38290889,109793192
"Nov 15, 2013",2013,The Best Man Holiday,17000000,70525195,2310515,72835710
"Feb 13, 2009",2009,Friday the 13th,17000000,65002019,27668218,92670237
"Sep 28, 2012",2012,Pitch Perfect,17000000,65001093,51043254,116044347
"Aug 5, 1998",1998,Halloween: H2O,17000000,55041738,0,55041738
"Apr 5, 2013",2013,Evil Dead,17000000,54239856,43538500,97778356
"Aug 27, 2004",2004,Jet Li's Hero,17000000,53652140,123883818,177535958
"Oct 29, 2010",2010,Saw 3D,17000000,45710178,88025106,133735284
"Feb 20, 2015",2015,"McFarland, USA",17000000,44480275,1227649,45707924
"Nov 11, 2016",2016,Almost Christmas,17000000,42065185,428321,42493506
"Mar 10, 2006",2006,The Hills Have Eyes,17000000,41778863,28576950,70355813
"Mar 1, 2002",2002,40 Days and 40 Nights,17000000,37939782,57152885,95092667
"Oct 10, 2003",2003,Good Boy!,17000000,37667746,7644471,45312217
"Jan 26, 2007",2007,Smokin' Aces,17000000,35662731,21600709,57263440
"Oct 2, 1998",1998,A Night at the Roxbury,17000000,30331165,0,30331165
"Mar 4, 2011",2011,Beastly,17000000,27865571,10162659,38028230
"Mar 5, 2010",2010,Brooklyn's Finest,17000000,27163593,12069640,39233233
"Jul 9, 1982",1982,Tron,17000000,26918576,0,26918576
"Aug 20, 2010",2010,Lottery Ticket,17000000,24719879,0,24719879
"Sep 5, 2003",2003,Dickie Roberts: Former Child Star,17000000,22734486,1000000,23734486
"Mar 31, 2006",2006,ATL,17000000,21170563,0,21170563
"Aug 24, 2001",2001,Summer Catch,17000000,19693891,0,19693891
"Dec 11, 1998",1998,A Simple Plan,17000000,16316273,0,16316273
"Mar 24, 2006",2006,Larry the Cable Guy: Health Inspector,17000000,15680099,0,15680099
"Nov 27, 2002",2002,Wes Craven Presents: They,17000000,12840842,3300000,16140842
"Oct 1, 1999",1999,The Adventures of Elmo in Grouchland,17000000,11634458,0,11634458
"Jul 24, 1987",1987,Superman IV: The Quest for Peace,17000000,11227824,0,11227824
"May 29, 1963",1963,55 Days at Peking,17000000,10000000,0,10000000
"Jun 5, 2009",2009,My Life in Ruins,17000000,8677425,11800000,20477425
"Apr 21, 2006",2006,American Dreamz,17000000,7314027,9196944,16510971
"Jan 25, 2008",2008,How She Move,17000000,7070641,1537174,8607815
"Feb 24, 2006",2006,Running Scared,17000000,6855137,2873951,9729088
"Aug 24, 2012",2012,The Apparition,17000000,4936819,5700462,10637281
"Apr 30, 2004",2004,Bobby Jones: Stroke of Genius,17000000,2694071,0,2694071
"Aug 29, 1986",1986,Shanghai Surprise,17000000,2315000,0,2315000
"Dec 25, 2010",2010,L'illusionniste,17000000,2231474,6378475,8609949
"Jan 1, 1981",1981,Roar,17000000,2110050,0,2110050
"Oct 17, 2003",2003,Veronica Guerin,17000000,1569918,7868156,9438074
"Jun 10, 2016",2016,Genius,17000000,1361045,5904238,7265283
"Nov 14, 2007",2007,Southland Tales,17000000,275380,89227,364607
"Jun 26, 2015",2015,Escobar: Paradise Lost,17000000,195792,3721887,3917679
"Sep 26, 2017",2017,"Mune, le gardien de la lune",17000000,0,14534046,14534046
"Jun 23, 2009",2009,Chasseurs de dragons,17000000,0,13446115,13446115
"Oct 21, 1977",1977,Damnation Alley,17000000,0,0,0
"Jul 12, 2019",2019,Crawl,17000000,0,0,0
"Mar 11, 2016",2016,The Young Messiah,16800000,6469813,843884,7313697
"Nov 10, 2006",2006,FUR: An Imaginary Portrait of Diane Arbus,16800000,223202,2057887,2281089
"Nov 27, 1991",1991,My Girl,16500000,58011485,0,58011485
"Dec 11, 1987",1987,Wall Street,16500000,43848100,0,43848100
"Dec 11, 1995",1995,Sense and Sensibility,16500000,42993774,92000000,134993774
"Aug 18, 2006",2006,The Illusionist,16500000,39868642,43923420,83792062
"Aug 3, 2007",2007,Becoming Jane,16500000,18663911,20716965,39380876
"Dec 19, 2003",2003,House of Sand and Fog,16500000,13005485,3152438,16157923
"Sep 21, 2007",2007,Sydney White,16500000,11892415,1743924,13636339
"Dec 31, 2007",2007,Arn - Tempelriddaren,16500000,0,21404122,21404122
"Jun 2, 1989",1989,Dead Poets Society,16400000,95860116,143639884,239500000
"Dec 16, 1994",1994,Dumb & Dumber,16000000,127175374,119224626,246400000
"Jul 14, 1989",1989,When Harry Met Sallyâ¦,16000000,92823546,138414,92961960
"May 19, 2000",2000,Road Trip,16000000,68525609,51213501,119739110
"Dec 8, 1982",1982,The Verdict,16000000,53977250,0,53977250
"Jan 15, 1999",1999,Varsity Blues,16000000,52894169,1400000,54294169
"May 25, 2012",2012,Moonrise Kingdom,16000000,45512466,23335980,68848446
"Nov 25, 2011",2011,The Artist,16000000,44667095,83589617,128256712
"Jan 9, 2009",2009,The Unborn,16000000,42670410,35538402,78208812
"Aug 2, 2002",2002,The Master of Disguise,16000000,40363530,0,40363530
"Oct 6, 2006",2006,The Texas Chainsaw Massacre: The Beginning,16000000,39517763,11000000,50517763
"Dec 29, 2006",2006,El Laberinto del Fauno,16000000,37634615,49406954,87041569
"Feb 4, 2011",2011,The Roommate,16000000,37300107,15245600,52545707
"Feb 2, 2007",2007,The Messengers,16000000,35374833,18400000,53774833
"Mar 2, 2001",2001,See Spot Run,16000000,33357476,9700076,43057552
"Aug 9, 1991",1991,Double Impact,16000000,29090445,0,29090445
"Jun 27, 2001",2001,Baby Boy,16000000,28734552,0,28734552
"Apr 11, 2001",2001,Joe Dirt,16000000,27087695,3900000,30987695
"Sep 12, 2008",2008,The Women,16000000,26902075,23201733,50103808
"Apr 20, 2007",2007,Hot Fuzz,16000000,23618786,58123832,81742618
"Aug 15, 2008",2008,Vicky Cristina Barcelona,16000000,23216709,81288108,104504817
"Jun 16, 2000",2000,Boys and Girls,16000000,21799652,0,21799652
"Jun 13, 2018",2018,Superfly,16000000,20537137,186444,20723581
"Nov 18, 1994",1994,LÃ©on,16000000,19284974,26000000,45284974
"Mar 12, 2010",2010,Remember Me,16000000,19068240,37437880,56506120
"Oct 11, 2002",2002,White Oleander,16000000,16357770,5300000,21657770
"Sep 18, 2009",2009,Jennifer's Body,16000000,16204793,15738608,31943401
"Mar 3, 2000",2000,Drowning Mona,16000000,15427192,553184,15980376
"Jan 30, 1987",1987,Radio Days,16000000,14792779,0,14792779
"Jul 18, 2003",2003,How to Deal,16000000,14108518,0,14108518
"Oct 3, 2014",2014,Left Behind,16000000,14019924,6749285,20769209
"May 28, 2004",2004,Soul Plane,16000000,13922211,631596,14553807
"Dec 9, 1988",1988,My Stepmother Is an Alien,16000000,13854000,0,13854000
"Jun 29, 2012",2012,People Like Us,16000000,12431792,185680,12617472
"May 28, 1999",1999,The Thirteenth Floor,16000000,11810854,0,11810854
"Sep 3, 2004",2004,The Cookout,16000000,11540112,0,11540112
"Oct 19, 1979",1979,Meteor,16000000,8400000,0,8400000
"Mar 7, 1986",1986,Highlander,16000000,5900000,7000000,12900000
"Nov 18, 2016",2016,Bleed for This,16000000,5083906,1520020,6603926
"May 3, 2002",2002,Hollywood Ending,16000000,4839383,10000000,14839383
"Sep 15, 2000",2000,Duets,16000000,4734235,1881217,6615452
"Aug 13, 1999",1999,Detroit Rock City,16000000,4217115,1608199,5825314
"Oct 19, 2007",2007,Things We Lost in the Fire,16000000,3287315,4832833,8120148
"Nov 14, 2014",2014,The Homesman,16000000,2429989,5787582,8217571
"Apr 5, 2013",2013,Trance,16000000,2322593,20271459,22594052
"May 16, 2014",2014,The Immigrant,16000000,2013456,5571555,7585011
"Aug 15, 1997",1997,Steel,16000000,1686429,0,1686429
"Dec 21, 2005",2005,The White Countess,16000000,1669971,1144595,2814566
"Jul 25, 2008",2008,Bienvenue chez les Ch'tis,16000000,1477650,245996847,247474497
"Oct 1, 2014",2014,"Men, Women and Children",16000000,705908,979495,1685403
"Sep 24, 2010",2010,Enter the Void,16000000,337997,1129281,1467278
"Dec 31, 2008",2008,Good,16000000,31631,0,31631
"Nov 2, 2012",2012,Vamps,16000000,3361,91451,94812
"May 11, 2010",2010,Haeundae,16000000,0,64733391,64733391
"Mar 9, 2010",2010,Hachiko: A Dog's Story,16000000,0,47707417,47707417
"Dec 31, 2013",2013,Zulu,16000000,0,1844228,1844228
"Dec 21, 2018",2018,Second Act,15700000,39282227,24006627,63288854
"Jun 21, 2002",2002,Juwanna Mann,15600000,13571817,200000,13771817
"Jun 8, 2007",2007,La MÃ´me,15500000,10299782,78312055,88611837
"Nov 15, 2002",2002,Ararat,15500000,1693000,0,1693000
"Apr 13, 2007",2007,Slow Burn,15500000,1237615,0,1237615
"Apr 22, 2005",2005,Madison,15500000,517262,0,517262
"Feb 26, 2010",2010,The Yellow Handkerchief,15500000,318623,0,318623
"Sep 27, 2002",2002,Wasabi,15300000,81525,6918475,7000000
"Mar 31, 2006",2006,Slither,15250000,7802450,5127893,12930343
"Nov 16, 1990",1990,Home Alone,15000000,285761243,190923432,476684675
"Dec 5, 1984",1984,Beverly Hills Cop,15000000,234760478,81539522,316300000
"May 16, 1986",1986,Top Gun,15000000,179800601,176999033,356799634
"Dec 17, 1982",1982,Tootsie,15000000,177200000,0,177200000
"Nov 25, 1987",1987,3 Men and a Baby,15000000,167780960,0,167780960
"Nov 26, 2010",2010,The Kingâs Speech,15000000,138797449,292023719,430821168
"Sep 15, 1999",1999,American Beauty,15000000,130058047,226200000,356258047
"Dec 8, 2000",2000,"Crouching Tiger, Hidden Dragon",15000000,128067808,85446864,213514672
"Dec 9, 1988",1988,Twins,15000000,111936388,104663612,216600000
"Dec 20, 1996",1996,Scream,15000000,103046663,70000000,173046663
"Aug 11, 2017",2017,Annabelle: Creation,15000000,102092201,203292664,305384865
"Oct 25, 2013",2013,Jackass Presents: Bad Grandpa,15000000,102003019,58900000,160903019
"Jun 28, 1978",1978,Heaven Can Wait,15000000,98800000,0,98800000
"Dec 18, 1985",1985,The Color Purple,15000000,93589701,0,93589701
"Nov 28, 2014",2014,The Imitation Game,15000000,91125143,136615320,227740463
"Mar 30, 1988",1988,Beetlejuice,15000000,73839613,47933,73887546
"Nov 18, 1959",1959,Ben-Hur,15000000,73000000,259017,73259017
"Jan 18, 2013",2013,Mama,15000000,71628180,76467386,148095566
"Oct 10, 1980",1980,Private Benjamin,15000000,69847348,0,69847348
"Mar 7, 1980",1980,Coal Miner's Daughter,15000000,67182787,0,67182787
"Mar 6, 1987",1987,Lethal Weapon,15000000,65192350,55000000,120192350
"Mar 19, 2010",2010,Diary of a Wimpy Kid,15000000,64003625,12950686,76954311
"Jul 29, 1983",1983,National Lampoonâs Vacation,15000000,61400000,0,61400000
"Aug 31, 2007",2007,Halloween,15000000,58269151,19245250,77514401
"Sep 30, 2006",2006,The Queen,15000000,56441711,72444162,128885873
"Oct 12, 2007",2007,Why Did I Get Married?,15000000,55204525,729653,55934178
"Feb 3, 2012",2012,The Woman in Black,15000000,54333290,74622608,128955898
"Dec 21, 1994",1994,Little Women,15000000,50003303,0,50003303
"Jan 1, 1979",1979,The Deer Hunter,15000000,50000000,9253,50009253
"Aug 10, 2018",2018,BlacKkKlansman,15000000,49275340,43741995,93017335
"Feb 3, 2006",2006,When a Stranger Calls,15000000,47860214,19355221,67215435
"Feb 8, 2002",2002,Big Fat Liar,15000000,47811275,4649742,52461017
"Aug 15, 1997",1997,Cop Land,15000000,44906632,18800000,63706632
"Dec 25, 1997",1997,Wag the Dog,15000000,43057470,21194568,64252038
"Feb 22, 2013",2013,Snitch,15000000,42930462,14977272,57907734
"May 2, 2003",2003,The Lizzie McGuire Movie,15000000,42734455,12800000,55534455
"Dec 4, 2015",2015,Krampus,15000000,42725475,19062918,61788393
"Sep 21, 2012",2012,End of Watch,15000000,41003371,16583235,57586606
"Dec 25, 1998",1998,The Faculty,15000000,40283321,0,40283321
"Jun 9, 1993",1993,What's Love Got to Do With It,15000000,39100956,0,39100956
"Dec 14, 2001",2001,Not Another Teen Movie,15000000,37882551,24518792,62401343
"Dec 3, 2014",2014,Wild,15000000,37880356,14580187,52460543
"Dec 16, 1962",1962,Lawrence of Arabia,15000000,37495385,32500000,69995385
"Nov 7, 2014",2014,The Theory of Everything,15000000,35893537,87434155,123327692
"Sep 16, 2011",2011,Drive,15000000,35060689,46297241,81357930
"Mar 31, 2000",2000,The Skulls,15000000,35007180,0,35007180
"Oct 10, 1966",1966,Hawaii,15000000,34562222,0,34562222
"Nov 23, 2018",2018,The Favourite,15000000,34366783,59747146,94113929
"Apr 18, 2003",2003,Malibu's Most Wanted,15000000,34308901,190303,34499204
"Sep 4, 2009",2009,All About Steve,15000000,33862903,6264356,40127259
"Apr 28, 2000",2000,Where the Heart Is,15000000,33771174,7090880,40862054
"Aug 28, 2009",2009,Halloween 2,15000000,33392973,5119877,38512850
"Mar 13, 2009",2009,The Last House on the Left,15000000,32752215,13774028,46526243
"Feb 18, 2005",2005,Because of Winn-Dixie,15000000,32647042,861443,33508485
"Feb 4, 2005",2005,The Wedding Date,15000000,31726995,15448043,47175038
"Sep 25, 1987",1987,The Princess Bride,15000000,30857000,2628,30859628
"Jul 12, 2002",2002,Halloween: Resurrection,15000000,30259652,7400000,37659652
"Dec 25, 2007",2007,The Great Debaters,15000000,30226144,35149,30261293
"Aug 22, 2014",2014,When the Game Stands Tall,15000000,30127963,10949,30138912
"Jun 12, 1981",1981,Clash of the Titans,15000000,30000000,14400000,44400000
"Feb 20, 2004",2004,Confessions of a Teenage Drama Queen,15000000,29331068,3787786,33118854
"Apr 17, 1998",1998,The Object of my Affection,15000000,29145924,0,29145924
"May 11, 2007",2007,28 Weeks Later,15000000,28638916,35593798,64232714
"Apr 11, 1997",1997,Grosse Pointe Blank,15000000,28084357,2986055,31070412
"Apr 21, 2000",2000,Love and Basketball,15000000,27441122,268503,27709625
"Sep 8, 2017",2017,Home Again,15000000,27020284,10316590,37336874
"Oct 27, 2000",2000,Book of Shadows: Blair Witch 2,15000000,26421314,21300000,47721314
"Oct 10, 1997",1997,Boogie Nights,15000000,26410771,16700954,43111725
"Jul 23, 2010",2010,Ramona and Beezus,15000000,26167002,1302619,27469621
"Aug 27, 2014",2014,The November Man,15000000,25018119,9802216,34820335
"May 3, 1996",1996,The Craft,15000000,24769466,30900000,55669466
"Dec 28, 2005",2005,Match Point,15000000,23089926,64883909,87973835
"Nov 5, 1993",1993,The Remains of the Day,15000000,22954968,41000000,63954968
"Jan 15, 1993",1993,Nowhere to Run,15000000,22189039,30000000,52189039
"Sep 22, 2000",2000,Urban Legends: Final Cut,15000000,21468807,17105555,38574362
"Mar 29, 2013",2013,The Place Beyond the Pines,15000000,21403519,25607930,47011449
"Oct 20, 2006",2006,Flicka,15000000,21000147,896220,21896367
"Mar 23, 2007",2007,The Hills Have Eyes II,15000000,20804166,16662372,37466538
"Apr 29, 2016",2016,Keanu,15000000,20591853,96288,20688141
"Dec 22, 2010",2010,Country Strong,15000000,20218921,383066,20601987
"Oct 11, 2002",2002,Tuck Everlasting,15000000,19161999,182616,19344615
"Oct 13, 2006",2006,The Marine,15000000,18844784,3320824,22165608
"Jul 24, 1998",1998,Disturbing Behavior,15000000,17507368,1506870,19014238
"Mar 6, 1998",1998,The Big Lebowski,15000000,17498804,28690764,46189568
"Jul 25, 2014",2014,A Most Wanted Man,15000000,17237855,18831035,36068890
"Jun 26, 2009",2009,The Hurt Locker,15000000,17017811,32876412,49894223
"Jan 28, 2000",2000,Eye of the Beholder,15000000,16500786,1760079,18260865
"Nov 2, 2012",2012,The Man with the Iron Fists,15000000,15634090,6384898,22018988
"May 11, 1984",1984,Firestarter,15000000,15136870,0,15136870
"Feb 1, 2019",2019,Miss Bala,15000000,14998027,364271,15362298
"Nov 30, 2012",2012,Killing Them Softly,15000000,14945541,24292902,39238443
"Apr 20, 2001",2001,Freddy Got Fingered,15000000,14249005,0,14249005
"Aug 19, 2011",2011,One Day,15000000,13843771,45324921,59168692
"Jun 25, 2004",2004,De-Lovely,15000000,13337299,5187197,18524496
"Oct 2, 2009",2009,Whip It,15000000,13077184,5812788,18889972
"Jan 11, 2008",2008,The Pirates Who Don't Do Anything: A VeggieTales Movie,15000000,12981269,267175,13248444
"Jan 23, 2008",2008,U2 3D,15000000,12898847,13271555,26170402
"Sep 1, 2000",2000,Highlander: Endgame,15000000,12801190,0,12801190
"Jan 20, 2017",2017,The Founder,15000000,12786053,11617139,24403192
"Aug 25, 2006",2006,Idlewild,15000000,12669914,0,12669914
"Apr 25, 2003",2003,Confidence,15000000,12212417,0,12212417
"Oct 11, 2002",2002,Knockaround Guys,15000000,11660180,759520,12419700
"Aug 27, 1999",1999,The Muse,15000000,11614954,0,11614954
"Apr 3, 1998",1998,Barney's Great Adventure,15000000,11156471,0,11156471
"Mar 1, 1989",1989,New York Stories,15000000,10763469,0,10763469
"Nov 25, 1998",1998,Home Fries,15000000,10513979,0,10513979
"Mar 24, 2000",2000,Here on Earth,15000000,10494147,350980,10845127
"Oct 8, 2004",2004,Raise Your Voice,15000000,10411980,4400000,14811980
"Dec 18, 1985",1985,Brazil,15000000,9929135,3011,9932146
"Apr 23, 1993",1993,The Dark Half,15000000,9579068,0,9579068
"Mar 2, 2007",2007,Black Snake Moan,15000000,9396870,1554283,10951153
"Feb 21, 2003",2003,Dark Blue,15000000,9237470,3024595,12262065
"Jun 22, 2007",2007,A Mighty Heart,15000000,9176787,9976781,19153568
"Sep 30, 1983",1983,Brainstorm,15000000,8921050,0,8921050
"Sep 23, 2016",2016,Queen of Katwe,15000000,8874389,1181092,10055481
"Mar 24, 2000",2000,Whatever it Takes,15000000,8735529,0,8735529
"Mar 21, 2003",2003,Boat Trip,15000000,8586376,6347337,14933713
"May 22, 2002",2002,The Importance of Being Earnest,15000000,8378141,0,8378141
"May 21, 1999",1999,The Love Letter,15000000,8322608,688372,9010980
"May 5, 2006",2006,Hoot,15000000,8117637,107361,8224998
"Feb 8, 2008",2008,In Bruges,15000000,7800825,26732958,34533783
"Jan 4, 2013",2013,Promised Land,15000000,7597898,4796664,12394562
"Oct 8, 2001",2001,Mulholland Drive,15000000,7219578,13566395,20785973
"Jun 8, 2018",2018,Hotel Artemis,15000000,6708137,6050662,12758799
"Aug 20, 2008",2008,The Rocker,15000000,6409528,2357810,8767338
"Aug 21, 2009",2009,Post Grad,15000000,6382178,181224,6563402
"Jun 19, 2009",2009,Whatever Works,15000000,5306706,29800000,35106706
"Jul 19, 2000",2000,The In Crowd,15000000,5217498,0,5217498
"Dec 14, 2005",2005,Los tres entierros de Melquiades Estrada,15000000,5027684,8426790,13454474
"Sep 24, 1999",1999,Jakob the Liar,15000000,4956401,0,4956401
"Sep 28, 2007",2007,Se jie,15000000,4604982,60562448,65167430
"Oct 21, 2005",2005,"Kiss Kiss, Bang Bang",15000000,4235837,12593627,16829464
"Apr 30, 1999",1999,Idle Hands,15000000,4023741,0,4023741
"Oct 30, 2015",2015,Scouts Guide to the Zombie Apocalypse,15000000,3703046,11851809,15554855
"Jan 26, 2007",2007,Blood and Chocolate,15000000,3526588,3024722,6551310
"Sep 22, 2010",2010,You Will Meet a Tall Dark Stranger,15000000,3247816,31000000,34247816
"Oct 23, 2015",2015,Rock the Kasbah,15000000,3020665,365488,3386153
"Sep 15, 2010",2010,Never Let Me Go,15000000,2434652,8739066,11173718
"Sep 9, 2016",2016,The Disappointments Room,15000000,2423467,1080294,3503761
"Dec 25, 2003",2003,The Company,15000000,2281585,1114923,3396508
"Jul 18, 2008",2008,Transsiberian,15000000,2203641,4175934,6379575
"Oct 22, 1999",1999,Crazy in Alabama,15000000,1954202,0,1954202
"Jan 17, 1986",1986,The Clan of the Cave Bear,15000000,1953732,0,1953732
"Feb 3, 2017",2017,The Comedian,15000000,1658706,0,1658706
"Mar 14, 2008",2008,Funny Games,15000000,1294640,6905487,8200127
"Jun 2, 2006",2006,Banlieue 13,15000000,1200216,10399687,11599903
"Nov 12, 1999",1999,Felicia's Journey,15000000,824295,1145973,1970268
"Jan 25, 2002",2002,Metropolis,15000000,673414,731618,1405032
"Oct 16, 2015",2015,CÃ¬kÃ¨ NiÃ¨ YinniÃ¡ng,15000000,632542,10647342,11279884
"Dec 1, 1995",1995,Things to Do in Denver when You're Dead,15000000,529766,0,529766
"Apr 26, 2013",2013,The Reluctant Fundamentalist,15000000,528731,0,528731
"Feb 6, 2004",2004,The Return,15000000,501752,5452134,5953886
"Jul 25, 2003",2003,Buffalo Soldiers,15000000,353743,0,353743
"Apr 25, 2003",2003,Steal (Canadian Release),15000000,220944,0,220944
"Aug 27, 2010",2010,Centurion,15000000,123570,7761478,7885048
"Oct 23, 2009",2009,Ong-Bak 2,15000000,102458,7480592,7583050
"Dec 31, 1996",1996,Silent Trigger,15000000,76382,0,76382
"Aug 1, 2008",2008,Midnight Meat Train,15000000,73548,1516698,1590246
"Sep 6, 2013",2013,Winnie Mandela,15000000,61847,0,61847
"Nov 4, 2011",2011,The Son of No One,15000000,30680,1117898,1148578
"Oct 25, 2002",2002,All the Queen's Men,15000000,22723,0,22723
"Oct 5, 2007",2007,The Good Night,15000000,22441,0,22441
"Dec 6, 2013",2013,Khumba,15000000,0,20898221,20898221
"May 5, 2015",2015,A Few Best Men,15000000,0,17224539,17224539
"Oct 10, 2014",2014,AutÃ³mata,15000000,0,6775458,6775458
"Dec 31, 2015",2015,Chiamatemi Francesco - Il papa della gente,15000000,0,3925769,3925769
"Dec 31, 2008",2008,Bathory,15000000,0,3436763,3436763
"Feb 5, 2010",2010,San suk si gin,15000000,0,2013340,2013340
"Dec 31, 2005",2005,Dungeons & Dragons: Wrath of the Dragon God,15000000,0,909822,909822
"Feb 17, 2017",2017,In Dubious Battle,15000000,0,214182,214182
"Sep 1, 2015",2015,Broken Horses,15000000,0,3471,3471
"Jun 29, 2001",2001,Pandaemonium,15000000,0,0,0
"Aug 14, 2019",2019,Blinded by the Light,15000000,0,0,0
"Feb 12, 1993",1993,Groundhog Day,14600000,70906973,0,70906973
"Jul 1, 2015",2015,Magic Mike XXL,14500000,66013057,57647540,123660597
"Nov 1, 1996",1996,Romeo+Juliet,14500000,46338728,101203653,147542381
"Jul 22, 2011",2011,Elle s'appelait Sarah,14500000,7691700,17788331,25480031
"Jun 5, 2015",2015,Freedom,14500000,0,872757,872757
"Aug 7, 1992",1992,Unforgiven,14400000,101157447,58000000,159157447
"Jan 27, 2006",2006,Manderlay,14200000,74205,469101,543306
"Mar 23, 1990",1990,Pretty Woman,14000000,178406268,254239604,432645872
"Sep 18, 1987",1987,Fatal Attraction,14000000,156645693,163454307,320100000
"Nov 12, 2008",2008,Slumdog Millionaire,14000000,141330703,243199737,384530440
"Dec 17, 1974",1974,Towering Inferno,14000000,116000000,23700000,139700000
"May 25, 1988",1988,Crocodile Dundee 2,14000000,109306210,130300000,239606210
"Dec 20, 1989",1989,Born on the Fourth of July,14000000,70001698,0,70001698
"Oct 1, 1993",1993,Cool Runnings,14000000,68856263,86200000,155056263
"Jan 12, 2007",2007,Stomp the Yard,14000000,61356221,14169497,75525718
"Jan 16, 2009",2009,My Bloody Valentine,14000000,51545952,51290050,102836002
"Aug 31, 2012",2012,The Possession,14000000,49130588,33794476,82925064
"Oct 22, 1982",1982,First Blood,14000000,47212904,78000000,125212904
"Jul 13, 1977",1977,The Spy Who Loved Me,14000000,46800000,138600000,185400000
"Sep 25, 1998",1998,Urban Legend,14000000,38116707,34455157,72571864
"Dec 9, 1981",1981,Taps,14000000,35856053,0,35856053
"Feb 24, 2012",2012,Tyler Perry's Good Deeds,14000000,35025791,553386,35579177
"Jan 18, 1991",1991,White Fang,14000000,34729091,0,34729091
"Dec 21, 1988",1988,Dangerous Liaisons,14000000,34700000,0,34700000
"Oct 8, 1999",1999,Superstar,14000000,30628981,0,30628981
"Jan 13, 2012",2012,The Iron Lady,14000000,29959436,85632668,115592104
"Jul 23, 1993",1993,Poetic Justice,14000000,27450453,0,27450453
"Oct 4, 2002",2002,Jonah: A VeggieTales Movie,14000000,25571351,37428,25608779
"Mar 8, 2002",2002,All About the Benjamins,14000000,25482931,390214,25873145
"Jun 17, 1977",1977,Exorcist II: The Heretic,14000000,25011000,0,25011000
"Mar 12, 2010",2010,Our Family Wedding,14000000,20255281,1155265,21410546
"Oct 27, 1995",1995,Vampire in Brooklyn,14000000,19637147,0,19637147
"May 5, 2006",2006,An American Haunting,14000000,16298046,14145231,30443277
"Aug 22, 2003",2003,My Boss's Daughter,14000000,15549702,0,15549702
"Aug 7, 2009",2009,A Perfect Getaway,14000000,15515460,7300000,22815460
"Oct 25, 1996",1996,Thinner,14000000,15171475,0,15171475
"Aug 21, 1998",1998,Dead Man on Campus,14000000,15064948,0,15064948
"May 14, 1999",1999,Tea with Mussolini,14000000,14395874,0,14395874
"Jun 22, 1977",1977,"New York, New York",14000000,13800000,0,13800000
"Apr 26, 2002",2002,Jason X,14000000,13121555,3830243,16951798
"May 13, 1994",1994,Crooklyn,14000000,13024170,0,13024170
"Mar 16, 2007",2007,I Think I Love My Wife,14000000,12559771,645640,13205411
"Feb 20, 2015",2015,Hot Tub Time Machine 2,14000000,12314651,511993,12826644
"Nov 17, 2006",2006,Bobby,14000000,11242801,9355005,20597806
"Feb 2, 2001",2001,Head Over Heels,14000000,10397365,0,10397365
"Oct 26, 2012",2012,Fun Size,14000000,9409538,1757077,11166615
"Apr 23, 1999",1999,Lost and Found,14000000,6552255,0,6552255
"Nov 30, 2007",2007,Le Scaphandre et le Papillon,14000000,5990075,16764397,22754472
"Oct 6, 2006",2006,Little Children,14000000,5463019,8658158,14121177
"Apr 21, 2000",2000,Gossip,14000000,5108820,7482450,12591270
"Mar 26, 1999",1999,A Walk on the Moon,14000000,4741987,0,4741987
"Oct 23, 2015",2015,Suffragette,14000000,4702420,29342489,34044909
"Oct 27, 2006",2006,Catch a Fire,14000000,4299773,1482425,5782198
"Dec 19, 2014",2014,Mr. Turner,14000000,3958546,21228480,25187026
"Sep 7, 2001",2001,Soul Survivors,14000000,3100650,1187596,4288246
"May 22, 2009",2009,Easy Virtue,14000000,2656784,17880957,20537741
"Mar 31, 1995",1995,Jefferson in Paris,14000000,2461628,0,2461628
"Aug 6, 2010",2010,Flipped,14000000,1755212,2534781,4289993
"Jan 1, 1978",1978,Caravans,14000000,1000000,0,1000000
"Jun 25, 2010",2010,Les herbes folles,14000000,403952,1500000,1903952
"Jan 24, 2003",2003,Amen,14000000,274299,0,274299
"Sep 26, 2008",2008,The Lucky Ones,14000000,266967,0,266967
"Sep 30, 2011",2011,Margaret,14000000,47185,576107,623292
"Nov 1, 2016",2016,Reign of Assassins,14000000,0,11354230,11354230
"Oct 27, 2009",2009,Stan Helsing: A Parody,14000000,0,1553556,1553556
"Dec 9, 2005",2005,Brokeback Mountain,13900000,83043761,93937102,176980863
"Jul 1, 1995",1995,Clueless,13700000,56598476,0,56598476
"Dec 31, 2008",2008,Ca$h,13700000,0,11738256,11738256
"Mar 30, 1990",1990,Teenage Mutant Ninja Turtles,13500000,135265915,66734085,202000000
"Oct 5, 1956",1956,The Ten Commandments,13500000,85400591,33925,85434516
"Nov 8, 2002",2002,Far From Heaven,13500000,15901849,13126065,29027914
"Oct 12, 2012",2012,Seven Psychopaths,13500000,15024049,18011687,33035736
"Nov 22, 2000",2000,Quills,13500000,7060876,4671212,11732088
"Jan 29, 1982",1982,The Border,13500000,6118683,0,6118683
"Feb 18, 2005",2005,Der Untergang,13500000,5501940,88129804,93631744
"Mar 2, 2001",2001,The Caveman's Valentine,13500000,687081,205425,892506
"Apr 1, 2011",2011,The Last Godfather,13400000,164247,0,164247
"Apr 4, 2014",2014,Under the Skin,13300000,2614251,4615682,7229933
"Dec 17, 2004",2004,Mar adentro,13300000,2086345,37600000,39686345
"Sep 12, 2014",2014,No Good Deed,13200000,52543632,1779578,54323210
"Dec 23, 1987",1987,Good Morning Vietnam,13000000,123922370,0,123922370
"Dec 3, 2010",2010,Black Swan,13000000,106954678,224312032,331266710
"Jan 12, 2001",2001,Save the Last Dance,13000000,91038276,31206053,122244329
"Feb 11, 2011",2011,Justin Bieber: Never Say Never,13000000,73013910,26020215,99034125
"Jul 4, 2018",2018,The First Purge,13000000,69488745,67128560,136617305
"Mar 16, 2016",2016,Miracles from Heaven,13000000,61705123,12093613,73798736
"Feb 11, 2000",2000,Snow Day,13000000,60008303,2444624,62452927
"Jan 23, 2004",2004,The Butterfly Effect,13000000,57924679,37713913,95638592
"Dec 11, 1974",1974,The Godfather: Part II,13000000,57300000,0,57300000
"Jun 24, 2016",2016,The Shallows,13000000,55121623,63641819,118763442
"Jul 17, 1987",1987,RoboCop,13000000,53424681,0,53424681
"Aug 19, 1988",1988,A Nightmare on Elm Street 4: The Dream Master,13000000,49369899,0,49369899
"Nov 21, 2007",2007,This Christmas,13000000,49121934,611611,49733545
"Feb 14, 2014",2014,About Last Night,13000000,48637684,1808176,50445860
"Dec 15, 2000",2000,"Dude, Where's My Car?",13000000,46729374,26450923,73180297
"Aug 12, 1988",1988,Young Guns,13000000,44726644,0,44726644
"Oct 10, 2014",2014,St. Vincent,13000000,44137712,10699522,54837234
"Jul 2, 2014",2014,Earth to Echo,13000000,38934842,3239703,42174545
"Mar 31, 1999",1999,10 Things I Hate About You,13000000,38177966,22235984,60413950
"May 10, 2002",2002,The New Guy,13000000,28972187,0,28972187
"Feb 5, 1993",1993,Loaded Weapon 1,13000000,27979399,0,27979399
"Mar 12, 1999",1999,Baby Geniuses,13000000,27151490,0,27151490
"Apr 24, 1998",1998,The Big Hit,13000000,27066941,0,27066941
"Nov 9, 1990",1990,Child's Play 2,13000000,26904572,7262000,34166572
"Jul 10, 1996",1996,Harriet the Spy,13000000,26570048,0,26570048
"Mar 1, 2013",2013,21 and Over,13000000,25682380,16513386,42195766
"Nov 21, 2007",2007,The Mist,13000000,25593755,31595653,57189408
"Apr 10, 2015",2015,Ex Machina,13000000,25440971,12917421,38358392
"Oct 29, 1999",1999,Being John Malkovich,13000000,22858926,9523455,32382381
"Sep 7, 2001",2001,Two Can Play That Game,13000000,22235901,155549,22391450
"Mar 11, 2016",2016,Eye in the Sky,13000000,18704596,16698206,35402802
"Mar 22, 2013",2013,Admission,13000000,18007317,726349,18733666
"Sep 21, 2012",2012,The Perks of Being a Wallflower,13000000,17742948,15326355,33069303
"Jun 29, 2001",2001,crazy/beautiful,13000000,16929123,3000000,19929123
"Aug 28, 1998",1998,54,13000000,16757163,0,16757163
"Oct 16, 2015",2015,Room,13000000,14677674,21585109,36262783
"Oct 16, 2015",2015,Woodlawn,13000000,14394097,9606,14403703
"Dec 20, 2006",2006,Letters from Iwo Jima,13000000,13756082,54111916,67867998
"May 29, 2009",2009,MÃ¤n som hatar kvinnor,13000000,12749992,96671919,109421911
"Feb 23, 2007",2007,The Astronaut Farmer,13000000,11003643,137570,11141213
"Jun 12, 1998",1998,Dirty Work,13000000,10020081,0,10020081
"Jul 17, 2015",2015,Bajrangi Bhaijaan,13000000,8178001,113600346,121778347
"May 8, 1998",1998,Woo,13000000,8064972,0,8064972
"Sep 9, 2016",2016,Robinson Crusoe,13000000,8005586,34440869,42446455
"Apr 13, 1994",1994,Serial Mom,13000000,7881335,0,7881335
"Aug 4, 1999",1999,Dick,13000000,6276869,0,6276869
"Nov 10, 1999",1999,Light It Up,13000000,5871603,0,5871603
"Aug 24, 2001",2001,Bubble Boy,13000000,5002310,0,5002310
"Feb 1, 2002",2002,Birthday Girl,13000000,4919896,3210831,8130727
"May 4, 2007",2007,"Paris, je t'aime",13000000,4857374,317714,5175088
"Dec 7, 2018",2018,Ben is Back,13000000,3703182,5929929,9633111
"Aug 24, 2007",2007,Resurrecting the Champ,13000000,3172382,88173,3260555
"Mar 26, 2010",2010,Chloe,13000000,3075255,8755876,11831131
"Mar 2, 2001",2001,The Widow of St. Pierre,13000000,3058380,0,3058380
"Dec 4, 2015",2015,Youth,13000000,2703296,21298277,24001573
"Apr 5, 1996",1996,Faithful,13000000,2104439,0,2104439
"Feb 26, 2010",2010,Un ProphÃ¨te,13000000,2087720,17822904,19910624
"Dec 3, 2010",2010,"I Love You, Phillip Morris",13000000,2037459,20976568,23014027
"Jul 24, 2015",2015,The Vatican Tapes,13000000,1784763,13144421,14929184
"Mar 17, 2006",2006,Find Me Guilty,13000000,1173673,1724552,2898225
"May 14, 1993",1993,Excessive Force,13000000,1152117,0,1152117
"Oct 13, 2006",2006,Infamous,13000000,1151330,1462387,2613717
"Jul 29, 2011",2011,Attack the Block,13000000,1024175,5435008,6459183
"Aug 14, 2015",2015,Brothers,13000000,656688,17200000,17856688
"Dec 29, 2000",2000,The Claim,13000000,622023,753612,1375635
"Dec 23, 2011",2011,In The Land of Blood and Honey,13000000,303877,205316,509193
"Jun 18, 2010",2010,The Killer Inside Me,13000000,217277,3400000,3617277
"Mar 30, 2012",2012,Womb,13000000,0,0,0
"Dec 31, 2019",2019,Rogue City,13000000,0,0,0
"Mar 15, 2013",2013,The Call,12800000,51872378,17949098,69821476
"Aug 5, 2016",2016,Operation Chromite,12700000,1022720,48173812,49196532
"Sep 12, 2014",2014,The Drop,12600000,10724389,8330145,19054534
"Jul 12, 2002",2002,The Crocodile Hunter: Collision Course,12500000,28436931,5000000,33436931
"Sep 3, 2010",2010,Machete,12500000,26593646,19777324,46370970
"Dec 19, 2002",2002,Antwone Fisher,12500000,21078145,2289441,23367586
"Feb 12, 1982",1982,La Guerre du feu,12500000,20959585,0,20959585
"Nov 22, 2002",2002,The Emperor's Club,12500000,14060950,2132763,16193713
"Sep 10, 1993",1993,True Romance,12500000,12281000,28980,12309980
"Sep 11, 2009",2009,Sorority Row,12500000,11965282,14770515,26735797
"Sep 30, 1992",1992,Glengarry Glen Ross,12500000,10725228,0,10725228
"Nov 7, 2008",2008,The Boy in the Striped Pyjamas,12500000,9046156,35037247,44083403
"Apr 2, 1982",1982,Cat People,12500000,7000000,14000000,21000000
"May 25, 1979",1979,The Prisoner of Zenda,12500000,7000000,0,7000000
"Oct 15, 2010",2010,Conviction,12500000,6797696,5029284,11826980
"Oct 12, 2007",2007,Lars and the Real Girl,12500000,5956480,5320639,11277119
"May 21, 2010",2010,Solitary Man,12500000,4360548,0,4360548
"Sep 22, 2000",2000,Dancer in the Dark,12500000,4157491,41400000,45557491
"Dec 17, 2010",2010,Casino Jack,12500000,2039869,232317,2272186
"Dec 31, 1997",1997,Oscar and Lucinda,12500000,1612957,0,1612957
"Nov 1, 1996",1996,The Funeral,12500000,1212799,200000,1412799
"Sep 3, 2004",2004,Tae Guik Gi: The Brotherhood of War,12500000,1110186,68716522,69826708
"Apr 16, 2010",2010,The Perfect Game,12500000,1089445,2841922,3931367
"Oct 5, 2012",2012,The Paperboy,12500000,677200,3350463,4027663
"Mar 1, 2013",2013,Ernest et Celestine,12500000,292562,9083882,9376444
"May 4, 2012",2012,A Little Bit of Heaven,12500000,10011,1090276,1100287
"Nov 18, 1988",1988,The Land Before Time,12300000,48092846,33880000,81972846
"Jun 20, 1975",1975,Jaws,12000000,260000000,210700000,470700000
"Dec 26, 1973",1973,The Exorcist,12000000,230347346,197867132,428214478
"Jun 6, 2014",2014,The Fault in Our Stars,12000000,124872350,182294484,307166834
"Jul 9, 1999",1999,American Pie,12000000,101800948,132922200,234723148
"Apr 20, 2012",2012,Think Like a Man,12000000,91547205,21826559,113373764
"Apr 16, 2014",2014,Heaven is for Real,12000000,91386097,9530202,100916299
"Dec 12, 1986",1986,The Golden Child,12000000,79817937,0,79817937
"Jun 4, 1982",1982,Star Trek II: The Wrath of Khan,12000000,78912963,16887037,95800000
"Sep 13, 2002",2002,Barbershop,12000000,75781642,1281819,77063461
"Jun 3, 1983",1983,WarGames,12000000,74433837,0,74433837
"Feb 4, 1994",1994,Ace Ventura: Pet Detective,12000000,72217396,35000000,107217396
"Feb 24, 2012",2012,Act of Valor,12000000,70012847,12484188,82497035
"Feb 8, 1985",1985,Witness,12000000,65532576,0,65532576
"Aug 11, 2006",2006,Step Up,12000000,65328121,45661036,110989157
"Feb 3, 2012",2012,Chronicle,12000000,64575175,59106615,123681790
"Dec 20, 1996",1996,Beavis and Butt-Head Do America,12000000,63118386,0,63118386
"Jan 1, 1970",1970,Patton,12000000,62500000,0,62500000
"Mar 2, 2012",2012,Project X,12000000,54731865,48296323,103028188
"Nov 10, 2017",2017,"Three Billboards Outside Ebbing, Missouri",12000000,54513740,105678175,160191915
"Nov 25, 2016",2016,Lion,12000000,51739495,97831225,149570720
"May 4, 2018",2018,Overboard,12000000,50316123,35053707,85369830
"Dec 25, 1997",1997,Jackie Brown,12000000,39673162,35054330,74727492
"Nov 18, 1983",1983,Yentl,12000000,39012241,0,39012241
"Apr 25, 2008",2008,Harold & Kumar Escape from Guantanamo Bay,12000000,38108728,5244389,43353117
"Nov 22, 2013",2013,Philomena,12000000,37709979,61253413,98963392
"Nov 6, 1981",1981,Time Bandits,12000000,37400000,0,37400000
"Feb 15, 2002",2002,Crossroads,12000000,37188667,19811333,57000000
"Jul 24, 2015",2015,Paper Towns,12000000,32000304,53450180,85450484
"Oct 10, 2008",2008,Quarantine,12000000,31691811,10232963,41924774
"Aug 21, 2002",2002,One Hour Photo,12000000,31597131,20626175,52223306
"Feb 1, 2008",2008,The Eye,12000000,31418697,26159068,57577765
"Apr 7, 2004",2004,Johnson Family Vacation,12000000,31203964,82795,31286759
"Dec 21, 2001",2001,How High,12000000,31155435,66960,31222395
"Oct 7, 1960",1960,Spartacus,12000000,30000000,30000000,60000000
"Sep 1, 2006",2006,Crank,12000000,27838408,16086515,43924923
"Dec 11, 1992",1992,The Muppet Christmas Carol,12000000,27281507,211411,27492918
"Aug 12, 2016",2016,Hell or High Water,12000000,27007844,10576460,37584304
"Oct 25, 2002",2002,Frida,12000000,25885000,30246239,56131239
"Jul 5, 2012",2012,Katy Perry: Part of Me,12000000,25326071,7374368,32700439
"Dec 12, 2014",2014,Top Five,12000000,25317379,684362,26001741
"Sep 11, 1998",1998,Rounders,12000000,22921898,0,22921898
"Apr 28, 1967",1967,Casino Royale,12000000,22744718,19000000,41744718
"Jun 15, 1979",1979,Prophecy,12000000,22673340,0,22673340
"Jan 30, 2015",2015,Project Almanac,12000000,22348241,10561196,32909437
"May 14, 2010",2010,Just Wright,12000000,21540363,327302,21867665
"Sep 10, 1999",1999,Stir of Echoes,12000000,21133087,0,21133087
"Jan 13, 1995",1995,Tales from the Crypt: Demon Knight,12000000,21089146,0,21089146
"Jan 1, 1978",1978,The Boys from Brazil,12000000,19000000,0,19000000
"Mar 11, 2005",2005,The Upside of Anger,12000000,18761993,10153768,28915761
"Mar 3, 2006",2006,Aquamarine,12000000,18597342,4381611,22978953
"Nov 15, 2013",2013,Nebraska,12000000,17654912,7106448,24761360
"Jan 9, 2004",2004,My Baby's Daddy,12000000,17321573,639,17322212
"Oct 5, 2001",2001,Max Keeble's Big Move,12000000,17292381,0,17292381
"Dec 9, 2011",2011,Young Adult,12000000,16311571,6438785,22750356
"Nov 1, 2013",2013,About Time,12000000,15323921,73985257,89309178
"Dec 14, 2018",2018,If Beale Street Could Talk,12000000,14915773,4943394,19859167
"Jul 14, 2017",2017,Wish Upon,12000000,14301505,9175840,23477345
"Aug 6, 1997",1997,Def Jam's How To Be a Player,12000000,14010363,0,14010363
"Oct 30, 1998",1998,Living Out Loud,12000000,12905901,0,12905901
"Oct 3, 2008",2008,Rachel Getting Married,12000000,12796861,4678614,17475475
"Mar 20, 1981",1981,The Postman Always Rings Twice,12000000,12200000,32000000,44200000
"Dec 12, 2003",2003,Girl with a Pearl Earring,12000000,11634362,31640435,43274797
"Feb 10, 1982",1982,Das Boot,12000000,11487676,73482661,84970337
"Apr 21, 2017",2017,Unforgettable,12000000,11368012,4853199,16221211
"Dec 3, 2004",2004,House of Flying Daggers,12000000,11050094,81813851,92863945
"Mar 22, 2002",2002,Sorority Boys,12000000,10198766,2317456,12516222
"Oct 13, 2017",2017,Marshall,12000000,10051659,65157,10116816
"Dec 5, 2008",2008,Cadillac Records,12000000,8195551,746965,8942516
"Sep 14, 2012",2012,Arbitrage,12000000,7919574,27911139,35830713
"Oct 24, 1960",1960,The Alamo,12000000,7900000,0,7900000
"May 12, 2000",2000,Screwed,12000000,6982680,0,6982680
"Oct 20, 2006",2006,Running With Scissors,12000000,6860000,1846701,8706701
"Sep 3, 1993",1993,Fortress,12000000,6730578,40000000,46730578
"Jun 1, 2012",2012,For Greater Glory: The True Story of Cristiada,12000000,5669081,4357174,10026255
"Nov 17, 2006",2006,For Your Consideration,12000000,5549923,0,5549923
"Nov 20, 1998",1998,Celebrity,12000000,5078660,1121340,6200000
"Jun 20, 2003",2003,From Justin to Kelly,12000000,4922166,0,4922166
"Jun 6, 1986",1986,Invaders from Mars,12000000,4884663,100000,4984663
"Mar 22, 1996",1996,Girl 6,12000000,4880941,0,4880941
"Oct 22, 2003",2003,In the Cut,12000000,4717455,18976191,23693646
"Feb 22, 2008",2008,Charlie Bartlett,12000000,3950294,1345615,5295909
"Feb 13, 2009",2009,Two Lovers,12000000,3149034,13200000,16349034
"Nov 15, 2013",2013,La grande bellezza,12000000,2883879,26665266,29549145
"Feb 15, 2002",2002,Last Orders,12000000,2326407,0,2326407
"Mar 9, 2007",2007,Gwoemul,12000000,2201923,90416194,92618117
"Nov 13, 1981",1981,The Pursuit of D.B. Cooper,12000000,2104164,0,2104164
"Mar 19, 1999",1999,Ravenous,12000000,2062406,0,2062406
"Jun 14, 2002",2002,The Dangerous Lives of Altar Boys,12000000,1779284,0,1779284
"Mar 1, 2013",2013,Stoker,12000000,1703125,10331788,12034913
"Mar 7, 2008",2008,Married Life,12000000,1506998,1468190,2975188
"Aug 5, 2005",2005,2046,12000000,1442338,17845147,19287485
"Mar 11, 2011",2011,Kill the Irishman,12000000,1188194,0,1188194
"Sep 30, 2005",2005,Duma,12000000,870067,124723,994790
"Apr 20, 2012",2012,Darling Companion,12000000,793352,406994,1200346
"Jun 4, 2010",2010,Ondine,12000000,550472,7073,557545
"Jul 20, 2001",2001,Brother,12000000,450594,0,450594
"Oct 4, 2002",2002,Welcome to Collinwood,12000000,378650,4227634,4606284
"Apr 18, 2008",2008,Life Before Her Eyes,12000000,303439,6900000,7203439
"Oct 31, 1997",1997,Critical Care,12000000,220175,0,220175
"Sep 28, 2007",2007,Trade,12000000,214202,1299186,1513388
"Jan 6, 2006",2006,Fateless,12000000,196857,0,196857
"Sep 3, 2010",2010,San qiang pai an jing qi,12000000,190946,120000,310946
"Sep 17, 1999",1999,Breakfast of Champions,12000000,178287,0,178287
"Mar 9, 2001",2001,Company Man,12000000,146028,476245,622273
"Nov 7, 2009",2009,Nanjing! Nanjing!,12000000,122558,20000000,20122558
"Oct 9, 2015",2015,Trash,12000000,17484,6535702,6553186
"Aug 19, 2011",2011,5 Days of War,12000000,17479,70314,87793
"Nov 11, 2015",2015,10 Days in a Madhouse,12000000,14616,0,14616
"Apr 7, 2009",2009,1612,12000000,0,5400624,5400624
"Dec 31, 2015",2015,San cheng ji,12000000,0,1950194,1950194
"Dec 31, 2011",2011,Tu Xia Chuan Qi,12000000,0,1828400,1828400
"Feb 10, 2010",2010,Triangle,12000000,0,1594955,1594955
"Oct 19, 2013",2013,Supesu Batorushippu Yamato,12000000,0,0,0
"Oct 3, 2014",2014,Drive Hard,12000000,0,0,0
"Oct 30, 2015",2015,Dancin' It's On,12000000,0,0,0
"Jun 5, 2009",2009,Home,12000000,0,0,0
"Sep 23, 2016",2016,The Dressmaker,11900000,2022115,22019502,24041617
"Dec 10, 1999",1999,Diamonds,11900000,81897,0,81897
"Mar 20, 1998",1998,Madadayo,11900000,48856,0,48856
"Nov 20, 2015",2015,Carol,11800000,12711491,30132030,42843521
"Apr 21, 1989",1989,Pet Sematary,11500000,57469179,0,57469179
"Jan 22, 2016",2016,Dirty Grandpa,11500000,35593113,69485336,105078449
"Nov 27, 2009",2009,The Cry of the Owl,11500000,0,0,0
"Oct 9, 2009",2009,St. Trinianâs,11400000,15000,29815239,29830239
"May 25, 1977",1977,Star Wars Ep. IV: A New Hope,11000000,460998007,325600000,786598007
"Jun 8, 1984",1984,Gremlins,11000000,148168459,31056,148199515
"Dec 22, 1965",1965,Doctor Zhivago,11000000,111897830,138493,112036323
"Dec 10, 2010",2010,The Fighter,11000000,93617009,35645379,129262388
"Oct 24, 2008",2008,High School Musical 3: Senior Year,11000000,90559416,183833464,274392880
"Dec 27, 1991",1991,Fried Green Tomatoes,11000000,81204830,0,81204830
"Sep 22, 2006",2006,Jackass: Number Two,11000000,72778712,12500000,85278712
"Mar 13, 1992",1992,My Cousin Vinny,11000000,52929168,0,52929168
"Aug 22, 2014",2014,If I Stay,11000000,50474843,27881327,78356170
"Apr 7, 1989",1989,Major League,11000000,49793054,0,49793054
"Apr 4, 2003",2003,Phone Booth,11000000,46566212,51270926,97837138
"Jan 25, 2002",2002,A Walk to Remember,11000000,41227069,4833792,46060861
"Dec 29, 1995",1995,Dead Man Walking,11000000,39387284,43701011,83088295
"Mar 5, 1999",1999,Cruel Intentions,11000000,38665260,37573641,76238901
"Nov 4, 2015",2015,Brooklyn,11000000,38322743,23753398,62076141
"Oct 17, 2008",2008,The Secret Life of Bees,11000000,37780486,2213861,39994347
"Apr 1, 2015",2015,Woman in Gold,11000000,33307793,25278614,58586407
"Jun 12, 1981",1981,History of the World: Part I,11000000,31672000,0,31672000
"Dec 8, 2017",2017,"I, Tonya",11000000,30014534,23782875,53797409
"Oct 23, 2009",2009,Saw VI,11000000,27693292,42059110,69752402
"Oct 12, 2001",2001,Corky Romano,11000000,23978402,1137701,25116103
"Feb 14, 2019",2019,Fighting With My Family,11000000,22958583,16091339,39049922
"Aug 7, 1992",1992,Raising Cain,11000000,21171695,0,21171695
"Apr 13, 1978",1978,F.I.S.T,11000000,20388920,0,20388920
"Jan 1, 1975",1975,Barry Lyndon,11000000,20000000,169934,20169934
"Jan 11, 2013",2013,Quartet,11000000,18388357,37790578,56178935
"Nov 21, 2001",2001,Out Cold,11000000,13906394,880000,14786394
"Oct 13, 2000",2000,The Ladies Man,11000000,13592872,126602,13719474
"Mar 30, 2001",2001,Tomcats,11000000,13558739,0,13558739
"Dec 6, 2013",2013,Inside Llewyn Davis,11000000,13248209,19695038,32943247
"Apr 12, 2002",2002,Frailty,11000000,13110448,6836832,19947280
"Feb 19, 1993",1993,Army of Darkness,11000000,11502976,10000000,21502976
"Nov 12, 2004",2004,Kinsey,11000000,10214647,7228882,17443529
"May 10, 2013",2013,Peeples,11000000,9177065,130101,9307166
"Dec 25, 1993",1993,What's Eating Gilbert Grape,11000000,9170214,0,9170214
"Jul 6, 2016",2016,Sultan,11000000,5599781,67390000,72989781
"Feb 1, 2002",2002,Slackers,11000000,4814244,1127974,5942218
"Sep 26, 2003",2003,The Gospel of John,11000000,4068087,166268,4234355
"Oct 10, 2004",2004,Vera Drake,11000000,3753806,9600049,13353855
"Jan 31, 2003",2003,The Guru,11000000,3051221,21099329,24150550
"Dec 14, 1995",1995,Othello,11000000,2844379,0,2844379
"May 12, 1995",1995,The Perez Family,11000000,2794056,0,2794056
"Jan 1, 1970",1970,The Molly Maguires,11000000,2200000,0,2200000
"Jan 1, 1991",1991,Return to the Blue Lagoon,11000000,2000000,0,2000000
"Sep 7, 2007",2007,Romance and Cigarettes,11000000,551002,2680249,3231251
"Nov 10, 2006",2006,Copying Beethoven,11000000,355968,6230356,6586324
"Aug 26, 2011",2011,Brighton Rock,11000000,229653,0,229653
"Nov 16, 2012",2012,Le prÃ©nom,11000000,61611,25245794,25307405
"May 8, 2015",2015,La famille BÃ©lier,11000000,0,82438670,82438670
"May 4, 2012",2012,LOL,11000000,0,10431506,10431506
"Feb 5, 2016",2016,Misconduct,11000000,0,2352511,2352511
"Dec 31, 2019",2019,Eli,11000000,0,0,0
"Oct 24, 2008",2008,Saw V,10800000,56746769,61463009,118209778
"May 25, 2012",2012,Les Intouchables,10800000,13182281,471690764,484873045
"Apr 27, 2007",2007,Jindabyne,10800000,399879,2462665,2862544
"Aug 11, 2006",2006,Kabhi Alvida Naa Kehna,10750000,3275443,29300000,32575443
"May 25, 1979",1979,Alien,10700000,80930630,122698317,203628947
"Jun 4, 1982",1982,Poltergeist,10700000,74706019,47000000,121706019
"Jun 18, 1999",1999,An Ideal Husband,10700000,18542974,12798209,31341183
"Dec 25, 2004",2004,Darkness,10600000,22163442,12245764,34409206
"Dec 6, 2013",2013,The Last Days on Mars,10600000,24084,237280,261364
"Jun 11, 1982",1982,ET: The Extra-Terrestrial,10500000,435110554,357854772,792965326
"Apr 2, 1968",1968,2001: A Space Odyssey,10500000,59936321,11991725,71928046
"Apr 20, 2007",2007,In the Land of Women,10500000,11052958,3087444,14140402
"Dec 31, 1994",1994,There Goes My Baby,10500000,125169,0,125169
"Feb 20, 2004",2004,The Blue Butterfly,10400000,1610194,0,1610194
"Nov 2, 2001",2001,Le Fabuleux destin d'AmÃ©lie Poulain,10350000,33201661,141000000,174201661
"Jan 4, 2019",2019,PMC: deo beong-keo,10300000,0,12478635,12478635
"Feb 18, 1983",1983,Lovesick,10100000,10143618,0,10143618
"Apr 30, 2010",2010,Housefull,10100000,1183658,17542642,18726300
"Aug 24, 2007",2007,September Dawn,10100000,1066555,0,1066555
"Oct 19, 2018",2018,Halloween,10000000,159342015,95558652,254900667
"Dec 5, 1997",1997,Good Will Hunting,10000000,138433435,87492554,225925989
"Oct 22, 2004",2004,The Grudge,10000000,110359362,76921753,187281115
"Aug 26, 2016",2016,Donât Breathe,10000000,89217875,69755810,158973685
"Jun 26, 1981",1981,Stripes,10000000,85300000,0,85300000
"Oct 27, 2006",2006,Saw III,10000000,80238724,83638091,163876815
"Jul 1, 2016",2016,The Purge: Election Year,10000000,79042440,39472287,118514727
"May 18, 2018",2018,Book Club,10000000,68566296,22547387,91113683
"Aug 25, 2000",2000,Bring it On,10000000,68353550,22100000,90453550
"Jan 5, 2018",2018,Insidious: The Last Key,10000000,67745330,100140258,167885588
"Jan 29, 1999",1999,She's All That,10000000,63465522,0,63465522
"Oct 26, 2007",2007,Saw IV,10000000,63300095,72459599,135759694
"Feb 24, 2006",2006,Madea's Family Reunion,10000000,63257940,62581,63320521
"Jan 7, 2005",2005,White Noise,10000000,56094360,36000000,92094360
"Oct 17, 1986",1986,The Color of Money,10000000,52293000,0,52293000
"Jun 5, 2015",2015,Insidious Chapter 3,10000000,52218558,68234597,120453155
"Oct 2, 1992",1992,The Mighty Ducks,10000000,50752337,0,50752337
"Nov 3, 2017",2017,Lady Bird,10000000,48958273,29652496,78610769
"Nov 6, 2009",2009,Precious (Based on the Novel Push by Sapphire),10000000,47566524,21156324,68722848
"May 4, 2012",2012,The Best Exotic Marigold Hotel,10000000,46383639,88256141,134639780
"Jun 8, 2018",2018,Hereditary,10000000,44069456,26064449,70133905
"Mar 16, 2018",2018,"Love, Simon",10000000,40826341,24694292,65520633
"Feb 17, 1989",1989,Bill & Ted's Excellent Adventure,10000000,40485039,0,40485039
"Oct 4, 1962",1962,The Longest Day,10000000,39100000,11000000,50100000
"Feb 16, 1996",1996,Happy Gilmore,10000000,38623460,2380952,41004412
"Oct 27, 2017",2017,Jigsaw,10000000,38052832,64392364,102445196
"Aug 31, 2001",2001,Jeepers Creepers,10000000,37904175,21034860,58939035
"Jun 28, 1985",1985,St. Elmoâs Fire,10000000,37800000,0,37800000
"Dec 11, 1968",1968,Oliver!,10000000,37402877,0,37402877
"Feb 16, 2001",2001,Recess: School's Out,10000000,36696761,7754709,44451470
"Jul 10, 1985",1985,Mad Max Beyond Thunderdome,10000000,36230219,0,36230219
"Nov 3, 1977",1977,Peteâs Dragon,10000000,36000000,0,36000000
"Jan 22, 2016",2016,The Boy,10000000,35819556,32401396,68220952
"Oct 4, 1985",1985,Commando,10000000,35073978,0,35073978
"May 19, 2017",2017,"Everything, Everything",10000000,34121140,27481996,61603136
"Sep 17, 2010",2010,Devil,10000000,33679655,29674459,63354114
"Nov 22, 2002",2002,Friday After Next,10000000,33253609,273226,33526835
"Mar 6, 2015",2015,The Second Best Exotic Marigold Hotel,10000000,33078266,57306040,90384306
"Mar 22, 1985",1985,The Last Dragon,10000000,33000000,0,33000000
"Apr 28, 2017",2017,How to Be a Latin Lover,10000000,32149404,30406824,62556228
"Mar 6, 1992",1992,The Lawnmower Man,10000000,32100816,0,32100816
"Oct 3, 2008",2008,Nick and Norah's Infinite Playlist,10000000,31487293,2398724,33886017
"Dec 19, 2003",2003,Calendar Girls,10000000,31011616,62063000,93074616
"Nov 12, 1999",1999,Dogma,10000000,30651422,13297443,43948865
"Aug 10, 2018",2018,Slender Man,10000000,30564825,21158819,51723644
"Sep 20, 2002",2002,The Banger Sisters,10000000,30306281,7760937,38067218
"Dec 8, 2000",2000,Snatch,10000000,30093107,53500000,83593107
"May 19, 1989",1989,Road House,10000000,30050028,0,30050028
"Jul 27, 2018",2018,Teen Titans Go! To The Movies,10000000,29790236,21830357,51620593
"Sep 9, 2016",2016,When the Bough Breaks,10000000,29747603,1020846,30768449
"Jun 24, 1983",1983,Twilight Zone: The Movie,10000000,29500000,0,29500000
"Nov 23, 1994",1994,A Low Down Dirty Shame,10000000,29317886,0,29317886
"Aug 30, 2013",2013,One Direction: This is Us,10000000,28873374,39668412,68541786
"Sep 6, 2002",2002,Swimfan,10000000,28564995,5519233,34084228
"Oct 6, 2006",2006,Employee of the Month,10000000,28444855,9920000,38364855
"Aug 21, 2015",2015,Sinister 2,10000000,27740955,26363270,54104225
"Jan 8, 2016",2016,The Forest,10000000,26594261,14154969,40749230
"Nov 6, 2009",2009,The Fourth Kind,10000000,26218170,23268704,49486874
"Mar 25, 1983",1983,The Outsiders,10000000,25697647,0,25697647
"Jun 12, 1998",1998,Can't Hardly Wait,10000000,25358996,0,25358996
"Aug 17, 2012",2012,Sparkle,10000000,24397469,262854,24660323
"Oct 14, 2016",2016,Kevin Hart: What Now?,10000000,23591043,0,23591043
"Apr 26, 2013",2013,Mud,10000000,21590086,9966873,31556959
"Nov 12, 2010",2010,Skyline,10000000,21416355,46848618,68264973
"Dec 1, 2017",2017,The Disaster Artist,10000000,21120616,7597051,28717667
"Sep 16, 2016",2016,Blair Witch,10000000,20777061,18208516,38985577
"Oct 21, 1983",1983,The Dead Zone,10000000,20766000,0,20766000
"Feb 2, 2001",2001,Valentine,10000000,20384136,0,20384136
"Jun 9, 2006",2006,A Prairie Home Companion,10000000,20342852,6373339,26716191
"Feb 23, 2007",2007,Reno 911!: Miami,10000000,20342161,1509201,21851362
"Jul 24, 1998",1998,Jane Austen's Mafia,10000000,19843795,10300000,30143795
"Oct 23, 2015",2015,Paranormal Activity: The Ghost Dimension,10000000,18297124,59662250,77959374
"Feb 25, 1994",1994,Sugar Hill,10000000,18272447,151467,18423914
"Jun 20, 2008",2008,Kit Kittredge: An American Girl,10000000,17657973,0,17657973
"Sep 27, 1985",1985,Invasion U.S.A.,10000000,17536256,0,17536256
"Sep 23, 2005",2005,Roll Bounce,10000000,17380866,52206,17433072
"Dec 11, 1998",1998,Rushmore,10000000,17105219,1975216,19080435
"Jan 19, 1990",1990,Tremors,10000000,16667084,0,16667084
"Jun 17, 2005",2005,The Perfect Man,10000000,16535005,3000000,19535005
"Aug 3, 1990",1990,Mo' Better Blues,10000000,16153000,0,16153000
"Jan 25, 2002",2002,Kung Pow: Enter the Fist,10000000,16033556,1000000,17033556
"Oct 7, 2016",2016,The Birth of a Nation,10000000,15861566,1029445,16891011
"May 30, 2003",2003,Wrong Turn,10000000,15417771,13231785,28649556
"May 16, 1980",1980,The Long Riders,10000000,15198912,0,15198912
"Mar 12, 1999",1999,The Corruptor,10000000,15164492,0,15164492
"Aug 14, 2009",2009,"The Goods: Live Hard, Sell Hard",10000000,15122676,174642,15297318
"Nov 23, 2011",2011,My Week with Marilyn,10000000,14597405,19643167,34240572
"Dec 25, 2014",2014,Big Eyes,10000000,14482031,12835841,27317872
"Aug 5, 2005",2005,Broken Flowers,10000000,13744960,27000000,40744960
"Jun 28, 2002",2002,Hey Arnold! The Movie,10000000,13684949,0,13684949
"Dec 30, 2005",2005,The Matador,10000000,12589255,4711583,17300838
"Mar 14, 1997",1997,Love Jones,10000000,12554569,0,12554569
"Dec 19, 2000",2000,The Gift,10000000,12008642,32558964,44567606
"Jan 20, 2006",2006,End of the Spear,10000000,11748661,175380,11924041
"Mar 9, 2001",2001,Get Over It,10000000,11560259,8300000,19860259
"Oct 20, 2000",2000,The Legend of Drunken Master,10000000,11546543,0,11546543
"Feb 19, 1999",1999,Office Space,10000000,10827813,1351895,12179708
"Jul 23, 1999",1999,Drop Dead Gorgeous,10000000,10571408,0,10571408
"Apr 5, 2019",2019,The Best of Enemies,10000000,10205616,0,10205616
"Apr 3, 1998",1998,The Spanish Prisoner,10000000,10162034,3673096,13835130
"Jun 11, 1999",1999,Le Violon rouge,10000000,10019109,0,10019109
"Nov 25, 1998",1998,Very Bad Things,10000000,9949470,11145504,21094974
"Jul 9, 2004",2004,Sleepover,10000000,9408183,0,9408183
"Jan 25, 2013",2013,Movie 43,10000000,8840453,22324294,31164747
"Oct 19, 2018",2018,Can You Ever Forgive Me?,10000000,8803865,2948522,11752387
"Oct 26, 1984",1984,Body Double,10000000,8801940,0,8801940
"May 21, 2010",2010,MacGruber,10000000,8525600,104295,8629895
"Jul 18, 2003",2003,Dirty Pretty Things,10000000,8112414,6044339,14156753
"Mar 14, 2014",2014,Bad Words,10000000,7779614,63531,7843145
"Mar 27, 2015",2015,While We're Young,10000000,7582065,9921763,17503828
"Feb 1, 2008",2008,Over Her Dead Body,10000000,7570127,14025947,21596074
"Oct 24, 2001",2001,Bones,10000000,7316658,1062195,8378853
"Jun 22, 2012",2012,Seeking a Friend for the End of the World,10000000,7078738,4688221,11766959
"Dec 1, 2006",2006,Turistas,10000000,7027762,7293308,14321070
"Nov 11, 2016",2016,Shut In,10000000,6900335,4460330,11360665
"Feb 11, 2011",2011,Cedar Rapids,10000000,6861102,1001029,7862131
"Nov 30, 2012",2012,The Collection,10000000,6810754,2079340,8890094
"Oct 30, 1998",1998,American History X,10000000,6719864,0,6719864
"Jan 16, 2004",2004,Teacher's Pet: The Movie,10000000,6491969,0,6491969
"Oct 15, 1999",1999,The Straight Story,10000000,6197866,0,6197866
"May 3, 2002",2002,Deuces Wild,10000000,6044618,200000,6244618
"Mar 28, 2008",2008,"Run, Fatboy, Run",10000000,6003262,27508998,33512260
"Dec 18, 1981",1981,Heartbeeps,10000000,6000000,0,6000000
"Mar 20, 2015",2015,Danny Collins,10000000,5637066,2828779,8465845
"Jul 4, 2007",2007,Rescue Dawn,10000000,5490423,1547463,7037886
"Apr 5, 2000",2000,Black and White,10000000,5241315,0,5241315
"Jun 18, 2010",2010,Io sono lâamore,10000000,5005465,10116063,15121528
"Oct 26, 2001",2001,On the Line,10000000,4365455,325347,4690802
"Jun 15, 2018",2018,Gotti,10000000,4286367,1802733,6089100
"Mar 16, 2012",2012,"Jeff, Who Lives at Home",10000000,4269426,438701,4708127
"Sep 30, 2016",2016,Denial,10000000,4073448,5190492,9263940
"Apr 29, 2016",2016,The Man Who Knew Infinity,10000000,3877922,8504200,12382122
"Oct 14, 2016",2016,Max Steel,10000000,3818664,744416,4563080
"Mar 30, 2016",2016,Everybody Wants Some,10000000,3400278,2036848,5437126
"Oct 4, 1996",1996,Crash,10000000,3357324,0,3357324
"Oct 12, 2012",2012,Atlas Shrugged: Part II,10000000,3336053,0,3336053
"Feb 4, 1994",1994,Romeo Is Bleeding,10000000,3275585,0,3275585
"Oct 8, 1999",1999,The Limey,10000000,3193102,2836945,6030047
"Nov 14, 2014",2014,Rosewater,10000000,3128941,56776,3185717
"Dec 22, 2000",2000,The House of Mirth,10000000,3041803,2107328,5149131
"May 1, 1987",1987,Malone,10000000,3000000,0,3000000
"Jun 2, 2006",2006,Peaceful Warrior,10000000,2893666,366513,3260179
"Sep 9, 2011",2011,Bucky Larson: Born to Be a Star,10000000,2529395,0,2529395
"Oct 6, 2000",2000,Bamboozled,10000000,2185266,188671,2373937
"Feb 11, 1981",1981,Sphinx,10000000,2000000,9400000,11400000
"May 3, 2013",2013,The Iceman,10000000,1930282,1693327,3623609
"Jun 5, 2015",2015,Testament of Youth,10000000,1822250,4824419,6646669
"Apr 21, 2017",2017,Free Fire,10000000,1799322,1994417,3793739
"Jun 24, 2011",2011,A Better Life,10000000,1759252,124999,1884251
"Feb 28, 2003",2003,Spider,10000000,1641788,0,1641788
"Feb 4, 2000",2000,Gun Shy,10000000,1638202,0,1638202
"Dec 27, 2002",2002,Nicholas Nickleby,10000000,1562800,0,1562800
"Apr 16, 2010",2010,The Joneses,10000000,1475746,2065819,3541565
"Jun 23, 2006",2006,Krrish,10000000,1430721,31000000,32430721
"Jul 27, 2012",2012,Killer Joe,10000000,1291645,3367465,4659110
"Jun 2, 2017",2017,Churchill,10000000,1279681,6302515,7582196
"Aug 11, 2000",2000,Cecil B. Demented,10000000,1276984,676898,1953882
"Mar 21, 2014",2014,50 to 1,10000000,1069454,0,1069454
"May 2, 2003",2003,Owning Mahowny,10000000,1011054,0,1011054
"Oct 19, 2007",2007,The Ten Commandments,10000000,952820,99087,1051907
"Sep 7, 2007",2007,The Brothers Solomon,10000000,900926,0,900926
"Apr 4, 2008",2008,My Blueberry Nights,10000000,866778,21332218,22198996
"Aug 6, 1999",1999,Illuminata,10000000,836641,0,836641
"Jan 20, 2012",2012,Coriolanus,10000000,749641,1429982,2179623
"Oct 4, 2013",2013,Parkland,10000000,641439,974914,1616353
"Oct 11, 2002",2002,Swept Away,10000000,598645,0,598645
"May 23, 2008",2008,"War, Inc.",10000000,580862,718993,1299855
"Apr 2, 2004",2004,Shaolin Soccer,10000000,488872,42287160,42776032
"Aug 27, 2004",2004,The Brown Bunny,10000000,366301,264126,630427
"Sep 14, 2007",2007,King of California,10000000,268461,896641,1165102
"Oct 24, 1997",1997,Rien ne va plus,10000000,245359,4800000,5045359
"Aug 14, 1998",1998,La femme de chambre du Titanic,10000000,244465,0,244465
"Dec 17, 2004",2004,Imaginary Heroes,10000000,228524,62351,290875
"Oct 26, 2001",2001,High Heels and Low Lifes,10000000,226792,0,226792
"Aug 21, 2009",2009,World's Greatest Dad,10000000,221805,73945,295750
"May 3, 2013",2013,"Cinco de Mayo, La Batalla",10000000,173472,0,173472
"Oct 29, 2010",2010,Welcome to the Rileys,10000000,152857,203062,355919
"Sep 9, 2016",2016,Kicks,10000000,150191,0,150191
"Oct 9, 2009",2009,Free Style,10000000,141108,580000,721108
"Jun 1, 2012",2012,High School,10000000,139034,109099,248133
"May 18, 2007",2007,Severance,10000000,137221,5812781,5950002
"Jul 14, 2006",2006,Edmond,10000000,131719,110000,241719
"Apr 23, 2010",2010,Joheunnom nabbeunnom isanghannom,10000000,128486,42098171,42226657
"Aug 26, 1994",1994,Police Academy 7: Mission to Moscow,10000000,126247,0,126247
"Feb 19, 2010",2010,Blood Done Sign My Name,10000000,109383,0,109383
"Feb 19, 2010",2010,The Good Guy,10000000,100688,5772,106460
"Oct 23, 2009",2009,Motherhood,10000000,93388,630000,723388
"Oct 15, 2004",2004,Eulogy,10000000,70527,0,70527
"Nov 7, 2014",2014,Elsa & Fred,10000000,67657,130244,197901
"Feb 27, 1998",1998,An Alan Smithee Film: Burn Hollywood Burn,10000000,45779,0,45779
"Aug 28, 2009",2009,The Open Road,10000000,19716,0,19716
"Jul 10, 2015",2015,Strangerland,10000000,17472,143625,161097
"Mar 13, 2015",2015,Hross i oss,10000000,11894,0,11894
"Oct 16, 2009",2009,Janky Promoters,10000000,9069,0,9069
"Dec 21, 2007",2007,Blonde Ambition,10000000,6422,1531057,1537479
"Aug 6, 2010",2010,The Oxford Murders,10000000,4803,17699328,17704131
"Dec 26, 2014",2014,Barbecue,10000000,388,247177,247565
"Dec 31, 2010",2010,The Reef,10000000,0,15037867,15037867
"Jan 8, 2008",2008,White Noise 2: The Light,10000000,0,8243567,8243567
"Jul 21, 2015",2015,American Heist,10000000,0,2341218,2341218
"Oct 8, 2010",2010,It's a Wonderful Afterlife,10000000,0,1642939,1642939
"Jun 21, 2011",2011,You Got Served: Beat The World,10000000,0,1230542,1230542
"Aug 21, 2009",2009,Fifty Dead Men Walking,10000000,0,997921,997921
"Sep 26, 2014",2014,Plastic,10000000,0,575371,575371
"Mar 10, 2015",2015,Jungle Shuffle,10000000,0,360898,360898
"Sep 22, 2009",2009,Adam Resurrected,10000000,0,90909,90909
"May 26, 2009",2009,The Devil's Tomb,10000000,0,0,0
"Dec 31, 2009",2009,Good Intentions,10000000,0,0,0
"Feb 2, 2007",2007,Partition,10000000,0,0,0
"Apr 13, 2012",2012,Detention,10000000,0,0,0
"Feb 7, 2014",2014,Nurse 3D,10000000,0,0,0
"May 19, 2015",2015,Into the Grizzly Maze,10000000,0,0,0
"Sep 22, 2017",2017,Friend Request,9900000,3759078,7551757,11310835
"Apr 30, 2010",2010,Gunless,9900000,458054,0,458054
"Apr 3, 2009",2009,Adventureland,9800000,16044025,1509030,17553055
"Dec 19, 2012",2012,Amour,9700000,6738954,30048090,36787044
"Apr 28, 2006",2006,The Lost City,9600000,2484186,2772653,5256839
"Jan 12, 2000",2000,Next Friday,9500000,57176582,2498725,59675307
"Jun 13, 1967",1967,You Only Live Twice,9500000,43100000,68500000,111600000
"Jun 10, 1988",1988,Poltergeist III,9500000,14114000,0,14114000
"Dec 21, 2016",2016,Dangal,9500000,12391761,282262857,294654618
"Mar 19, 2010",2010,The Runaways,9500000,3573673,1704959,5278632
"Oct 30, 2009",2009,Gentlemen Broncos,9500000,115155,4800,119955
"Dec 31, 2013",2013,Re-Kill,9500000,0,0,0
"Nov 7, 1963",1963,It's a Mad Mad Mad Mad World,9400000,46300000,13700000,60000000
"Nov 3, 2006",2006,Volver,9400000,12899867,74326746,87226613
"Nov 11, 2011",2011,Melancholia,9400000,3030848,18786450,21817298
"Aug 7, 1981",1981,Heavy Metal,9300000,19571091,0,19571091
"Nov 13, 2012",2012,Jab Tak Hai Jaan,9200000,3047539,2759127,5806666
"Dec 29, 1995",1995,Richard III,9200000,2684904,1514430,4199334
"May 21, 2010",2010,Kites,9200000,1685269,15469924,17155193
"Dec 31, 2011",2011,Red Dog,9100000,0,20927794,20927794
"Dec 31, 2010",2010,Mine Vaganti,9100000,0,18872126,18872126
"Oct 17, 2003",2003,The Texas Chainsaw Massacre,9000000,80571655,27395664,107967319
"Jan 1, 1971",1971,Fiddler on the Roof,9000000,80500000,0,80500000
"Jul 18, 2014",2014,The Purge: Anarchy,9000000,71562550,39972331,111534881
"Dec 29, 1965",1965,Thunderball,9000000,63600000,77600000,141200000
"May 30, 2008",2008,The Strangers,9000000,52597610,30454066,83051676
"Nov 6, 1996",1996,Set It Off,9000000,36049108,0,36049108
"Oct 21, 2016",2016,Ouija: Origin of Evil,9000000,35144505,46687361,81831866
"Oct 22, 1999",1999,The Best Man,9000000,34102780,470000,34572780
"Nov 9, 1988",1988,Child's Play,9000000,33244684,10952000,44196684
"Feb 13, 2019",2019,Happy Death Day 2U,9000000,28051045,36128450,64179495
"Jun 22, 2007",2007,Sicko,9000000,24538513,11997324,36535837
"Jan 30, 2015",2015,Black or White,9000000,21571189,399832,21971021
"Jan 21, 2000",2000,Down to You,9000000,20035310,0,20035310
"Jul 30, 2004",2004,Harold & Kumar Go to White Castle,9000000,18225165,0,18225165
"Oct 13, 2000",2000,The Contender,9000000,17804273,0,17804273
"Feb 18, 2000",2000,Boiler Room,9000000,16963963,11809674,28773637
"Dec 5, 2006",2006,Black Christmas,9000000,16235738,0,16235738
"Nov 18, 2016",2016,The Edge of Seventeen,9000000,14431633,4664370,19096003
"Dec 2, 2016",2016,Jackie,9000000,13960394,22628118,36588512
"Mar 16, 1984",1984,The Ice Pirates,9000000,13075390,0,13075390
"May 14, 2004",2004,Breakin' All the Rules,9000000,12232382,279935,12512317
"Aug 12, 2011",2011,Glee: The 3D Concert Movie,9000000,11862398,5600000,17462398
"Nov 8, 1989",1989,Henry V,9000000,10161099,15602,10176701
"Nov 4, 2016",2016,Loving,9000000,7710234,5187830,12898064
"Nov 28, 2007",2007,The Savages,9000000,6623082,4018941,10642023
"Apr 16, 2003",2003,Chasing Papi,9000000,6126237,6531140,12657377
"Sep 8, 2000",2000,The Way of the Gun,9000000,6047856,7014079,13061935
"May 17, 2019",2019,The Sun is Also a Star,9000000,4950029,484000,5434029
"Aug 22, 2008",2008,Hamlet 2,9000000,4886216,47888,4934104
"Sep 13, 2002",2002,Igby Goes Down,9000000,4777465,0,4777465
"Apr 29, 1994",1994,PCU,9000000,4333569,0,4333569
"Mar 9, 2007",2007,The Ultimate Gift,9000000,3438735,0,3438735
"Sep 29, 2000",2000,Beautiful,9000000,3134509,0,3134509
"Jun 1, 2007",2007,Gracie,9000000,2956339,965704,3922043
"Mar 22, 2013",2013,The Sapphires,9000000,2450867,17944173,20395040
"Aug 26, 2016",2016,Greater,9000000,2000093,0,2000093
"Dec 25, 2018",2018,Destroyer,9000000,1533324,2147772,3681096
"Aug 18, 2006",2006,Trust the Man,9000000,1530535,1017843,2548378
"Aug 26, 2005",2005,Undiscovered,9000000,1069318,0,1069318
"Nov 6, 1998",1998,Velvet Goldmine,9000000,1053788,3259856,4313644
"May 14, 2010",2010,Princess Kaiulani,9000000,883887,0,883887
"Jun 20, 2003",2003,The Legend of Suriyothai,9000000,454255,0,454255
"Oct 25, 1991",1991,Due occhi diabolici,9000000,349618,0,349618
"May 6, 2016",2016,Dheepan,9000000,248795,7455562,7704357
"Jan 22, 2010",2010,La fille du RER,9000000,208163,0,208163
"Oct 25, 2002",2002,All or Nothing,9000000,184255,0,184255
"Feb 5, 2010",2010,Red Riding: The Year of Our Lord 1974,9000000,148826,0,148826
"Jul 31, 2009",2009,Flammen og Citronen,9000000,148089,1487152,1635241
"Apr 2, 2010",2010,Leaves of Grass,9000000,70066,15461,85527
"Nov 22, 2006",2006,Opal Dream,9000000,14443,0,14443
"May 8, 2015",2015,Skin Trade,9000000,1242,0,1242
"Jun 17, 2014",2014,Beneath Hill 60,9000000,0,3440939,3440939
"Jan 20, 2015",2015,Veronika Decides to Die,9000000,0,2243,2243
"Oct 10, 1968",1968,Barbarella,9000000,0,0,0
"Feb 1, 2013",2013,A Haunting in Connecticut 2: The Ghosts of Georgia,9000000,0,0,0
"May 18, 2012",2012,Polisse,8900000,176988,22567144,22744132
"Nov 13, 2015",2015,Heist,8900000,50136,3273995,3324131
"Feb 26, 2011",2011,Ultramarines,8900000,0,0,0
"Sep 26, 1986",1986,Crocodile Dundee,8800000,174803506,153400000,328203506
"Dec 31, 2004",2004,The I Inside,8800000,0,0,0
"Nov 30, 2007",2007,Awake,8600000,14373825,18594823,32968648
"Nov 18, 2016",2016,Manchester by the Sea,8500000,47695371,30038496,77733867
"Dec 16, 2009",2009,Crazy Heart,8500000,39471742,7945509,47417251
"Aug 15, 2008",2008,Star Wars: The Clone Wars,8500000,35161554,33533889,68695443
"Feb 20, 2015",2015,The DUFF,8500000,34030343,9498291,43528634
"Oct 31, 2014",2014,Nightcrawler,8500000,32381218,17953200,50334418
"Jul 31, 1987",1987,The Lost Boys,8500000,32222567,0,32222567
"Jan 16, 2019",2019,Dragon Ball Super: Broly,8500000,30376755,92371000,122747755
"Nov 7, 1979",1979,The Rose,8500000,29200000,0,29200000
"Sep 27, 2013",2013,Baggage Claim,8500000,21569509,1316327,22885836
"Oct 7, 2016",2016,Middle School: The Worst Years of My Life,8500000,20007149,3304144,23311293
"Mar 1, 1991",1991,Haakon Haakonsen,8500000,15024232,0,15024232
"Apr 23, 1999",1999,Election,8500000,14943582,2259272,17202854
"Mar 9, 2007",2007,The Namesake,8500000,13610521,6678253,20288774
"Oct 18, 2013",2013,All is Lost,8500000,6263670,4123144,10386814
"Feb 27, 2004",2004,Club Dread,8500000,5001655,2571896,7573551
"Sep 17, 2009",2009,Bright Star,8500000,4444637,12775454,17220091
"Sep 21, 2001",2001,Glitter,8500000,4273372,0,4273372
"Jun 13, 2014",2014,The Rover,8500000,1109199,2071053,3180252
"Apr 23, 2004",2004,Silmido,8500000,298347,30000000,30298347
"Nov 7, 2008",2008,Repo! The Genetic Opera,8500000,140244,58639,198883
"Dec 31, 2017",2017,Posledniy bogatyr,8500000,0,30700192,30700192
"Nov 1, 2016",2016,A.C.O.R.N.S.: Operation Crackdown,8500000,0,1353287,1353287
"Feb 12, 2010",2010,My Name is Khan,8470000,4046336,38309190,42355526
"Mar 23, 2007",2007,Namastey London,8400000,1207007,5624062,6831069
"May 31, 2013",2013,Yeh Jawaani Hai Deewani,8300000,3827466,47000000,50827466
"Jun 4, 1999",1999,Limbo,8300000,2160710,437514,2598224
"Mar 16, 2007",2007,The Wind That Shakes the Barley,8300000,1829142,23841032,25670174
"Apr 16, 2010",2010,The City of Your Final Destination,8300000,493296,860000,1353296
"Nov 24, 2006",2006,Kurtlar vadisi - Irak,8300000,0,24906717,24906717
"Feb 23, 1951",1951,Quo Vadis?,8250000,30000000,28513,30028513
"Mar 2, 1965",1965,The Sound of Music,8200000,163214286,123000000,286214286
"Feb 17, 1984",1984,Footloose,8200000,80000000,0,80000000
"Oct 14, 1994",1994,Pulp Fiction,8000000,107928762,105000000,212928762
"Jun 22, 1984",1984,The Karate Kid,8000000,90815558,0,90815558
"Jun 22, 1979",1979,The Muppet Movie,8000000,76657000,0,76657000
"Mar 9, 1984",1984,Splash,8000000,62599495,0,62599495
"Jul 26, 2006",2006,Little Miss Sunshine,8000000,59891098,40751255,100642353
"Sep 17, 2010",2010,Easy A,8000000,58401464,17799257,76200721
"Aug 8, 1986",1986,Stand by Me,8000000,52287414,0,52287414
"Jun 27, 2003",2003,28 Days Laterâ¦,8000000,45064915,37890718,82955633
"Jun 22, 1979",1979,Escape from Alcatraz,8000000,43000000,0,43000000
"Jan 30, 2004",2004,You Got Served,8000000,40066497,10745361,50811858
"May 3, 2019",2019,The Intruder,8000000,35095904,909967,36005871
"Sep 30, 2011",2011,50/50,8000000,35016118,6318617,41334735
"Apr 3, 1996",1996,A Thin Line Between Love & Hate,8000000,34873513,0,34873513
"Sep 2, 2015",2015,A Walk in the Woods,8000000,29499394,7619964,37119358
"Oct 11, 2002",2002,Brown Sugar,8000000,27362712,952560,28315272
"Mar 13, 1992",1992,Howards End,8000000,26124872,193071,26317943
"Jan 31, 2014",2014,That Awkward Moment,8000000,26068955,27000000,53068955
"Mar 21, 2008",2008,Shutter,8000000,25928550,21853876,47782426
"Dec 25, 1981",1981,Modern Problems,8000000,24474312,0,24474312
"Dec 18, 1969",1969,On Her Majesty's Secret Service,8000000,22800000,59200000,82000000
"May 7, 1993",1993,Much Ado About Nothing,8000000,22549338,0,22549338
"Apr 10, 1992",1992,The Player,8000000,21706101,7170601,28876702
"Nov 10, 1982",1982,Creepshow,8000000,20036244,0,20036244
"Apr 28, 2006",2006,Akeelah and the Bee,8000000,18848430,110994,18959424
"Oct 14, 1994",1994,Wes Craven's New Nightmare,8000000,18090181,0,18090181
"Oct 1, 1999",1999,Drive Me Crazy,8000000,17843379,4748072,22591451
"Sep 18, 2013",2013,Enough Said,8000000,17550872,8070577,25621449
"Jan 16, 1998",1998,Half Baked,8000000,17394881,0,17394881
"Jan 30, 2009",2009,New in Town,8000000,16734283,13203626,29937909
"Jun 27, 2014",2014,Begin Again,8000000,16170632,52668104,68838736
"Apr 14, 2000",2000,American Psycho,8000000,15070285,19200000,34270285
"May 19, 2006",2006,See No Evil,8000000,15032800,3795236,18828036
"Aug 7, 2002",2002,The Good Girl,8000000,14018296,2567207,16585503
"Aug 4, 2006",2006,"Bon Cop, Bad Cop",8000000,12671300,69405,12740705
"Oct 30, 2009",2009,The Boondock Saints 2: All Saints Day,8000000,10273187,356133,10629320
"Apr 29, 2011",2011,Prom,8000000,10130219,632964,10763183
"Apr 22, 1994",1994,The Inkwell,8000000,8864699,0,8864699
"Dec 29, 2000",2000,Shadow of the Vampire,8000000,8279017,0,8279017
"Jun 12, 2015",2015,Me and Earl and the Dying Girl,8000000,6758416,2507764,9266180
"Oct 8, 2010",2010,It's Kind of a Funny Story,8000000,6363628,269322,6632950
"May 3, 1996",1996,The Pallbearer,8000000,5656388,0,5656388
"Sep 22, 2000",2000,Woman on Top,8000000,5018450,5174163,10192613
"May 12, 2000",2000,Held Up,8000000,4714090,0,4714090
"Sep 2, 2016",2016,Morgan,8000000,3915251,3383535,7298786
"Dec 30, 2015",2015,Anomalisa,8000000,3759286,1946882,5706168
"Dec 23, 2005",2005,CachÃ©,8000000,3647381,16243950,19891331
"Dec 29, 2010",2010,Another Year,8000000,3205706,16799907,20005613
"Sep 20, 2002",2002,8 femmes,8000000,3076425,39300000,42376425
"Jan 1, 1991",1991,Showdown in Little Tokyo,8000000,2275557,0,2275557
"Sep 25, 1998",1998,Clay Pigeons,8000000,1793359,463247,2256606
"Dec 20, 2013",2013,Le passÃ©,8000000,1335672,14416903,15752575
"Apr 6, 2018",2018,Lean on Pete,8000000,1163056,1291971,2455027
"Nov 19, 2010",2010,Made in Dagenham,8000000,1095369,14548827,15644196
"Jun 6, 2008",2008,And When Did You Last See Your Father?,8000000,1071240,1405251,2476491
"May 3, 2019",2019,El Chicano,8000000,700261,0,700261
"Mar 5, 2010",2010,The Secret of Kells,8000000,690290,2892507,3582797
"Jan 24, 1997",1997,Prefontaine,8000000,590817,0,590817
"Oct 28, 1983",1983,The Wicked Lady,8000000,589308,0,589308
"May 5, 2006",2006,Down in the Valley,8000000,568932,404511,973443
"May 11, 2007",2007,Brooklyn Rules,8000000,458232,0,458232
"Oct 24, 2003",2003,The Singing Detective,8000000,336456,188291,524747
"Jun 15, 2007",2007,Fido,8000000,298110,158704,456814
"Oct 26, 2018",2018,London Fields,8000000,252676,181056,433732
"Sep 16, 2011",2011,Restless,8000000,163753,2608758,2772511
"Jun 12, 1998",1998,The Land Girls,8000000,146083,0,146083
"May 18, 2007",2007,The Wendell Baker Story,8000000,127188,0,127188
"Oct 29, 2010",2010,Wild Target,8000000,109338,5204856,5314194
"Apr 18, 2008",2008,Pathology,8000000,109045,3161929,3270974
"Oct 5, 2012",2012,Wuthering Heights,8000000,100915,2620619,2721534
"Nov 18, 2016",2016,A Street Cat Named Bob,8000000,82703,17299990,17382693
"Aug 18, 2006",2006,10th & Wolf,8000000,54702,89080,143782
"May 22, 2015",2015,Aloft,8000000,53086,184602,237688
"Oct 14, 2011",2011,Fireflies in the Garden,8000000,36884,3550307,3587191
"Sep 23, 2005",2005,Dear Wendy,8000000,23106,423332,446438
"Apr 27, 2001",2001,Akira,8000000,19585,0,19585
"Dec 31, 2005",2005,Welcome to Dongmakgol,8000000,0,48000000,48000000
"Sep 20, 2013",2013,Feichang Xingyun,8000000,0,21970000,21970000
"Sep 29, 2017",2017,"Don Gato, el inicio de la pandilla",8000000,0,4604656,4604656
"Sep 4, 2007",2007,The Death and Life of Bobby Z,8000000,0,414617,414617
"Apr 24, 2018",2018,Backstabbing For Beginners,8000000,0,343773,343773
"Aug 12, 2014",2014,Swelter,8000000,0,44197,44197
"Nov 30, 2007",2007,Maurice Richard,8000000,0,0,0
"Feb 24, 2015",2015,Green Street Hooligans: Underground,8000000,0,0,0
"Dec 31, 2009",2009,Christmas in Beverly Hills,8000000,0,0,0
"Dec 31, 2015",2015,Henry Joseph Church,8000000,0,0,0
"May 6, 2016",2016,Code of Honor,8000000,0,0,0
"Jun 21, 2019",2019,Burn Your Maps,8000000,0,0,0
"Jan 27, 2006",2006,Imagine Me & You,7900000,672243,2457228,3129471
"Jul 4, 2003",2003,Swimming Pool,7800000,10130108,13891174,24021282
"Feb 23, 1990",1990,The Blood of Heroes,7700000,882290,0,882290
"Apr 14, 2015",2015,Loin des hommes,7700000,5336,1075092,1080428
"Dec 13, 1989",1989,Driving Miss Daisy,7500000,106593296,0,106593296
"Sep 26, 1997",1997,Soul Food,7500000,43492389,0,43492389
"Jul 17, 2009",2009,(500) Days of Summer,7500000,32425665,2013395,34439060
"Feb 23, 1996",1996,Rumble in the Bronx,7500000,32281907,3956845,36238752
"Mar 17, 2006",2006,Thank You For Smoking,7500000,24793509,15223153,40016662
"Jun 8, 2007",2007,Hostel: Part II,7500000,17544812,16061597,33606409
"Oct 9, 2009",2009,An Education,7500000,12574914,17077822,29652736
"Sep 4, 2009",2009,Extract,7500000,10823158,26000,10849158
"Dec 20, 2002",2002,Narc,7500000,10465659,1377601,11843260
"Oct 21, 2005",2005,Shopgirl,7500000,10284523,1473895,11758418
"Mar 9, 1984",1984,The Hotel New Hampshire,7500000,5142858,0,5142858
"Mar 8, 2002",2002,Men with Brooms,7500000,4239767,0,4239767
"Feb 22, 2008",2008,Witless Protection,7500000,4151836,0,4151836
"Nov 24, 2004",2004,The Work and the Glory,7500000,3347647,0,3347647
"Dec 21, 2011",2011,Albert Nobbs,7500000,3014696,5524307,8539003
"Jun 24, 2016",2016,The Neon Demon,7500000,1333124,2226679,3559803
"Jul 24, 2003",2003,Masked and Anonymous,7500000,533344,21991,555335
"Apr 13, 2018",2018,Borg vs McEnroe,7500000,231346,3026576,3257922
"Sep 13, 2002",2002,Betty Fisher et autres histoires,7500000,206400,0,206400
"Aug 6, 2004",2004,Code 46,7500000,197148,1591176,1788324
"Dec 31, 2001",2001,The Hole,7500000,0,10834406,10834406
"Jan 9, 2015",2015,Black November,7500000,0,32572,32572
"Feb 24, 2015",2015,Outside Bet,7500000,0,13524,13524
"May 15, 2015",2015,Pound of Flesh,7500000,0,0,0
"Jan 13, 2017",2017,The Bye Bye Man,7400000,22395806,8791921,31187727
"Apr 27, 2007",2007,Ta Ra Rum Pum,7400000,872643,8571221,9443864
"May 6, 2005",2005,Crash,7303082,55334418,45838620,101173038
"Dec 25, 2007",2007,Persepolis,7300000,4443403,20953784,25397187
"Apr 30, 2010",2010,Harry Brown,7300000,1818681,10204925,12023606
"May 27, 2011",2011,Die Welle,7250000,0,35122948,35122948
"Dec 17, 1971",1971,Diamonds Are Forever,7200000,43800000,72200000,116000000
"Oct 15, 1999",1999,The Omega Code,7200000,12610552,67760,12678312
"Sep 16, 2011",2011,3,7200000,59774,235718,295492
"Dec 5, 2007",2007,Juno,7000000,143495265,87954837,231450102
"Mar 15, 1972",1972,The Godfather,7000000,134966411,133533589,268500000
"Jun 29, 2012",2012,Magic Mike,7000000,113721571,56828182,170549753
"Apr 15, 1983",1983,Flashdance,7000000,90463574,111000000,201463574
"Mar 16, 2018",2018,I Can Only Imagine,7000000,83482352,2121869,85604221
"Mar 15, 2019",2019,Five Feet Apart,7000000,45729221,34775200,80504421
"Nov 12, 1993",1993,The Piano,7000000,40157856,11101,40168957
"May 6, 2011",2011,Jumping the Broom,7000000,37295394,863207,38158601
"Jun 27, 1973",1973,Live and Let Die,7000000,35400000,126400000,161800000
"Jan 12, 2000",2000,My Dog Skip,7000000,34099640,1695679,35795319
"Jan 24, 2003",2003,Darkness Falls,7000000,32539681,14750077,47289758
"Feb 14, 2008",2008,"Definitely, Maybe",7000000,32241649,23376217,55617866
"Oct 7, 2005",2005,"Good Night, and Good Luck",7000000,31501218,25085683,56586901
"Sep 30, 2005",2005,Capote,7000000,28750530,21173549,49924079
"Mar 29, 1974",1974,The Great Gatsby,7000000,26533200,0,26533200
"Aug 4, 2006",2006,The Descent,7000000,26024456,31026597,57051053
"Aug 25, 1995",1995,Desperado,7000000,25532388,0,25532388
"Jan 1, 1976",1976,Logan's Run,7000000,25000000,0,25000000
"Apr 7, 2017",2017,Gifted,7000000,24801212,12163444,36964656
"Mar 8, 1996",1996,Fargo,7000000,24567751,26636816,51204567
"Apr 11, 2001",2001,Kingdom Come,7000000,23247539,146400,23393939
"Dec 20, 1974",1974,The Man with the Golden Gun,7000000,21000000,76600000,97600000
"Feb 12, 1988",1988,Action Jackson,7000000,20257000,0,20257000
"May 13, 1983",1983,Breathless,7000000,19910002,0,19910002
"May 5, 2000",2000,Michael Jordan to the MAX,7000000,18642318,0,18642318
"Jun 19, 2015",2015,Dope,7000000,17506470,684361,18190831
"Jul 22, 2005",2005,The Devil's Rejects,7000000,17044981,3895447,20940428
"May 24, 2019",2019,BrightBurn,7000000,16794432,11195066,27989498
"Jan 17, 2014",2014,Devil's Due,7000000,15821461,20324626,36146087
"Mar 22, 1996",1996,Flirting with Disaster,7000000,14853474,1295706,16149180
"Nov 14, 2014",2014,Beyond the Lights,7000000,14618727,0,14618727
"Jul 31, 1992",1992,Buffy the Vampire Slayer,7000000,14231669,0,14231669
"Aug 25, 1999",1999,In Too Deep,7000000,14026509,1444720,15471229
"Apr 11, 2003",2003,"House of 1,000 Corpses",7000000,12634962,4370504,17005466
"Oct 11, 1985",1985,Silver Bullet,7000000,10803211,0,10803211
"Oct 10, 2003",2003,House of the Dead,7000000,10199354,3660724,13860078
"Oct 2, 2009",2009,A Serious Man,7000000,9228788,21131782,30360570
"Jul 30, 2010",2010,Get Low,7000000,9176933,1651372,10828305
"Dec 11, 2009",2009,A Single Man,7000000,9176000,18966379,28142379
"Jan 10, 1991",1991,Warlock,7000000,8824553,0,8824553
"Aug 12, 1988",1988,The Last Temptation of Christ,7000000,8373585,0,8373585
"Jun 18, 2010",2010,Cyrus,7000000,7468936,2593960,10062896
"Sep 1, 1999",1999,Outside Providence,7000000,7309628,514730,7824358
"Feb 11, 2005",2005,Bride & Prejudice,7000000,6601079,18667961,25269040
"Nov 29, 2002",2002,Rabbit-Proof Fence,7000000,6199600,10667328,16866928
"Jul 27, 2007",2007,Who's Your Caddy?,7000000,5694308,0,5694308
"May 1, 1992",1992,Split Second,7000000,5430822,0,5430822
"Mar 8, 1991",1991,Nikita,7000000,5017971,0,5017971
"Dec 14, 2001",2001,The Other Side of Heaven,7000000,4720371,0,4720371
"Sep 28, 1990",1990,Dark Angel,7000000,4372561,0,4372561
"Jun 27, 1986",1986,American Anthem,7000000,3571624,0,3571624
"Nov 12, 2004",2004,Veer-Zaara,7000000,2938532,4079327,7017859
"May 2, 2008",2008,Redbelt,7000000,2344847,322237,2667084
"Aug 27, 1999",1999,A Dog of Flanders,7000000,2165637,0,2165637
"Oct 18, 2002",2002,Auto Focus,7000000,2062066,641755,2703821
"Oct 21, 2011",2011,The Mighty Macs,7000000,1891936,0,1891936
"Dec 22, 2010",2010,Somewhere,7000000,1785645,15237476,17023121
"Jan 13, 2012",2012,We Need to Talk About Kevin,7000000,1738692,9026591,10765283
"Feb 2, 2007",2007,Factory Girl,7000000,1661464,0,1661464
"Nov 15, 2013",2013,The Christmas Candle,7000000,1632000,301829,1933829
"Sep 25, 2009",2009,I Hope They Serve Beer in Hell,7000000,1429299,154,1429453
"Apr 8, 1983",1983,Losin' It,7000000,1246141,0,1246141
"May 7, 2010",2010,Mother and Child,7000000,1110509,5426670,6537179
"Aug 5, 1977",1977,March or Die,7000000,1000000,0,1000000
"Jul 12, 1996",1996,Les Visiteurs,7000000,659000,98095000,98754000
"Oct 2, 2015",2015,Freeheld,7000000,546201,1186027,1732228
"Apr 2, 2014",2014,Dom Hemingway,7000000,523511,1333947,1857458
"Jul 30, 2010",2010,The Extra Man,7000000,453377,38731,492108
"May 13, 2011",2011,Hesher,7000000,382946,0,382946
"Mar 13, 1998",1998,Chairman of the Board,7000000,306715,0,306715
"Feb 14, 2003",2003,Gerry,7000000,254683,465016,719699
"May 12, 2006",2006,Wah-Wah,7000000,234750,228289,463039
"Jun 13, 2003",2003,The Heart of Me,7000000,196067,0,196067
"Mar 26, 2010",2010,Ca$h,7000000,46488,0,46488
"Jan 30, 2015",2015,Trudno byt bogom,7000000,31443,9595,41038
"Jan 21, 2000",2000,The Boondock Saints,7000000,30471,381403,411874
"Jan 28, 2014",2014,Snezhnaya koroleva,7000000,0,15193977,15193977
"Dec 6, 2016",2016,Oddball,7000000,0,10237229,10237229
"Aug 18, 2015",2015,Z Storm,7000000,0,2053330,2053330
"Dec 31, 2015",2015,Geroy,7000000,0,1545121,1545121
"Jul 23, 2013",2013,Twixt,7000000,0,1268346,1268346
"Nov 20, 2015",2015,Criminal Activities,7000000,0,386744,386744
"Dec 11, 2007",2007,High School Musical 2,7000000,0,0,0
"Dec 12, 2008",2008,The Kings of Appletown,7000000,0,0,0
"Mar 11, 2008",2008,Stargate - The Ark of Truth,7000000,0,0,0
"Sep 1, 2015",2015,Alpha & Omega: The Legend of the Saw Tooth Cave,7000000,0,0,0
"Jun 28, 1985",1985,Pale Rider,6900000,41410568,0,41410568
"Sep 21, 2012",2012,House at the End of the Street,6900000,31611916,12492066,44103982
"Sep 24, 1993",1993,Dazed and Confused,6900000,7950889,0,7950889
"Jan 31, 2017",2017,Two Lovers and a Bear,6840000,0,22273,22273
"Sep 17, 2010",2010,Incendies,6800000,6857096,9181247,16038343
"Aug 11, 2000",2000,AimÃ©e & Jaguar,6800000,927107,0,927107
"Aug 5, 2005",2005,The Chumscrubber,6800000,49526,0,49526
"Apr 9, 2004",2004,Shade,6800000,25032,9508932,9533964
"Sep 10, 2010",2010,Bran Nue Dae,6750000,113568,6698962,6812530
"Sep 3, 2004",2004,"Remember Me, My Love",6700000,223878,0,223878
"May 21, 2010",2010,Perrierâs Bounty,6600000,828,0,828
"Sep 19, 2008",2008,Tropa de Elite,6537890,8744,14310451,14319195
"Oct 3, 2014",2014,Annabelle,6500000,84273813,172589107,256862920
"Feb 1, 2008",2008,Hannah Montana/Miley Cyrus: Best of Both Worlds Concert Tour,6500000,65281781,5430318,70712099
"Jul 12, 1991",1991,Boyz n the Hood,6500000,56190094,25001,56215095
"Jul 24, 1987",1987,La Bamba,6500000,54215416,0,54215416
"May 22, 1981",1981,The Four Seasons,6500000,42488161,0,42488161
"Jan 1, 1980",1980,Dressed to Kill,6500000,31899000,0,31899000
"Apr 2, 1993",1993,The Adventures of Huck Finn,6500000,24103594,0,24103594
"Apr 9, 1999",1999,Go!,6500000,16875273,11508168,28383441
"Apr 7, 2006",2006,Friends with Money,6500000,13368437,4741715,18110152
"Jan 1, 1971",1971,The Andromeda Strain,6500000,12376563,0,12376563
"Oct 22, 1999",1999,Bats,6500000,10155691,0,10155691
"Oct 20, 2017",2017,Same Kind of Different as Me,6500000,6423605,0,6423605
"Mar 7, 2003",2003,Nowhere in Africa,6500000,6173485,0,6173485
"Dec 2, 2011",2011,Shame,6500000,4002293,16410548,20412841
"May 13, 2005",2005,Layer Cake,6500000,2339957,9405974,11745931
"May 31, 2013",2013,The East,6500000,2274649,753307,3027956
"Oct 21, 2005",2005,The Work and the Glory: American Zion,6500000,2025032,0,2025032
"Nov 13, 2009",2009,The Messenger,6500000,1109660,635292,1744952
"Jul 23, 2004",2004,A Home at the End of the World,6500000,1029017,4793,1033810
"Aug 17, 2001",2001,Aberdeen,6500000,64148,0,64148
"Dec 31, 2011",2011,Tracker,6500000,0,3149,3149
"Oct 26, 1984",1984,The Terminator,6400000,38019031,40000000,78019031
"Feb 27, 2004",2004,"Good Bye, Lenin!",6400000,4063859,75320680,79384539
"Oct 10, 2007",2007,Control,6400000,871577,8030564,8902141
"Oct 9, 2009",2009,The Damned United,6400000,449865,3750009,4199874
"Feb 22, 2008",2008,Die FÃ¤lscher,6250000,5488570,14711093,20199663
"Jan 15, 1988",1988,Return of the Living Dead Part II,6200000,9205924,0,9205924
"Feb 13, 2009",2009,Gomorra,6200000,1579146,35760448,37339594
"Oct 20, 1995",1995,Mallrats,6100000,2108367,0,2108367
"Jun 16, 1978",1978,Grease,6000000,181813770,205696409,387510179
"Dec 19, 1986",1986,Platoon,6000000,137963328,15067,137978395
"Jun 23, 2004",2004,Fahrenheit 9/11,6000000,119114517,102034442,221148959
"Oct 24, 1969",1969,Butch Cassidy and the Sundance Kid,6000000,102308900,1753,102310653
"Aug 26, 1964",1964,Mary Poppins,6000000,102272145,0,102272145
"Sep 19, 1980",1980,Ordinary People,6000000,52302978,0,52302978
"May 11, 2018",2018,Breaking In,6000000,46840590,4571030,51411620
"Oct 18, 1961",1961,West Side Story,6000000,43700000,0,43700000
"Oct 17, 1956",1956,Around the World in 80 Days,6000000,42000000,0,42000000
"Jul 25, 1980",1980,Caddyshack,6000000,39846344,0,39846344
"Mar 23, 2001",2001,The Brothers,6000000,27457409,500782,27958191
"Dec 17, 2008",2008,The Wrestler,6000000,26238243,20396032,46634275
"Jun 30, 1989",1989,Do the Right Thing,6000000,26004026,0,26004026
"Jul 10, 1981",1981,Escape from New York,6000000,25244700,1225,25245925
"Jul 16, 1999",1999,The Wood,6000000,25059640,0,25059640
"Aug 16, 1995",1995,The Usual Suspects,6000000,23341568,11107788,34449356
"Aug 11, 1989",1989,A Nightmare On Elm Street: The Dream Child,6000000,22168359,0,22168359
"Apr 5, 2002",2002,National Lampoonâs Van Wilder,6000000,21305259,17936064,39241323
"Dec 31, 1946",1946,Duel in the Sun,6000000,20400000,0,20400000
"Sep 27, 2000",2000,Best in Show,6000000,18621249,2074164,20695413
"Mar 29, 2019",2019,Unplanned,6000000,18107621,0,18107621
"Sep 27, 2006",2006,The Last King of Scotland,6000000,17606684,31548687,49155371
"Apr 16, 2003",2003,A Mighty Wind,6000000,17583468,921071,18504539
"Feb 8, 2019",2019,The Prodigy,6000000,14856291,4933421,19789712
"Nov 30, 2018",2018,The Possession of Hannah Grace,6000000,14836174,27949213,42785387
"Feb 12, 1988",1988,School Daze,6000000,14545844,0,14545844
"Aug 8, 2007",2007,Daddy Day Camp,6000000,13235267,4974605,18209872
"Oct 21, 1988",1988,Mystic Pizza,6000000,12793213,0,12793213
"Mar 20, 1998",1998,Mr. Nice Guy,6000000,12716953,19000000,31716953
"Aug 21, 1956",1956,War and Peace,6000000,12500000,24028,12524028
"Apr 24, 1998",1998,Sliding Doors,6000000,11911200,46897949,58809149
"May 24, 1995",1995,Tales from the Hood,6000000,11784569,0,11784569
"Oct 13, 1989",1989,Halloween 5: The Revenge of Michael Myers,6000000,11642254,0,11642254
"Sep 7, 2012",2012,The Words,6000000,11494838,4874870,16369708
"Jan 15, 2016",2016,The Lady in the Van,6000000,10021175,32299328,42320503
"Apr 27, 2012",2012,Bernie,6000000,9204489,902486,10106975
"Dec 15, 2000",2000,Pollock,6000000,8596914,1960377,10557291
"Feb 15, 2008",2008,Dolphins and Whales Tribes of the Ocean 3D,6000000,7714996,9537291,17252287
"Feb 26, 1999",1999,200 Cigarettes,6000000,6852450,0,6852450
"Mar 19, 2010",2010,City Island,6000000,6671283,1502203,8173486
"Mar 16, 2012",2012,Casa de mi Padre,6000000,5909483,2537469,8446952
"Jul 29, 2011",2011,The Guard,6000000,5359774,15837680,21197454
"Apr 21, 2000",2000,The Virgin Suicides,6000000,4859475,5760295,10619770
"Aug 29, 2008",2008,College,6000000,4694491,1481623,6176114
"Sep 22, 2006",2006,La science des rÃªves,6000000,4670644,10467288,15137932
"Dec 4, 1998",1998,Little Voice,6000000,4595000,17192233,21787233
"Mar 13, 2009",2009,Miss March,6000000,4543320,169739,4713059
"Feb 5, 1999",1999,Simply Irresistible,6000000,4398989,0,4398989
"Jul 18, 2014",2014,Wish I Was Here,6000000,3591299,3000066,6591365
"Dec 21, 2006",2006,Venus,6000000,3347411,4471068,7818479
"Mar 14, 2014",2014,Veronica Mars,6000000,3322127,163256,3485383
"Aug 27, 1993",1993,Only the Strong,6000000,3273588,0,3273588
"Jul 20, 2001",2001,Hedwig and the Angry Inch,6000000,3067312,672718,3740030
"Oct 31, 2003",2003,Shattered Glass,6000000,2207975,1248627,3456602
"Jul 3, 2008",2008,The Wackness,6000000,2077046,1252966,3330012
"Nov 16, 2001",2001,Novocaine,6000000,2025238,497690,2522928
"Feb 6, 2009",2009,Polytechnique,6000000,1418304,0,1418304
"Jul 15, 2011",2011,Snow Flower and the Secret Fan,6000000,1348205,10000000,11348205
"Sep 14, 2018",2018,Mandy,6000000,1214525,213131,1427656
"Dec 7, 2001",2001,The Business of Strangers,6000000,1030920,260000,1290920
"Apr 29, 2011",2011,JÃ»san-nin no shikaku,6000000,802778,17924662,18727440
"Aug 30, 1991",1991,Beastmaster 2: Through the Portal of Time,6000000,773490,0,773490
"Jun 18, 1969",1969,The Wild Bunch,6000000,509424,0,509424
"Mar 25, 2011",2011,The 5th Quarter,6000000,408159,0,408159
"Feb 2, 1979",1979,The First Great Train Robbery,6000000,391942,0,391942
"Dec 20, 2002",2002,Morvern Callar,6000000,267194,0,267194
"Oct 10, 2003",2003,The Flower of Evil,6000000,181798,0,181798
"Mar 4, 2011",2011,Akmareul Boatda,6000000,129210,13039599,13168809
"Nov 10, 2006",2006,Come Early Morning,6000000,119452,0,119452
"Apr 2, 2010",2010,The Greatest,6000000,115862,1934,117796
"Dec 7, 2012",2012,Deadfall,6000000,66351,1607284,1673635
"May 8, 2009",2009,Julia,6000000,65108,1300000,1365108
"Apr 5, 2002",2002,Lucky Break,6000000,54606,4261891,4316497
"Sep 5, 2008",2008,"Surfer, Dude",6000000,36497,0,36497
"Jan 23, 2015",2015,Song One,6000000,32251,404838,437089
"Oct 3, 2007",2007,Lake of Fire,6000000,25317,690,26007
"Apr 2, 2010",2010,Don McKay,6000000,13722,0,13722
"Aug 12, 2005",2005,11:14,6000000,0,0,0
"Feb 9, 2010",2010,Icarus,6000000,0,0,0
"Dec 19, 1995",1995,Men of War,6000000,0,0,0
"Mar 15, 2011",2011,A Shine of Rainbows,6000000,0,0,0
"Dec 31, 2011",2011,Freaky Deaky,6000000,0,0,0
"May 10, 2011",2011,The Hit List,6000000,0,0,0
"Feb 4, 1983",1983,Videodrome,5952000,2120439,0,2120439
"Aug 2, 1996",1996,Emma,5900000,22231658,15600000,37831658
"Mar 21, 2003",2003,L\'auberge espagnole,5900000,3895664,0,3895664
"Feb 8, 1968",1968,Planet of the Apes,5800000,33395426,0,33395426
"Mar 7, 1965",1965,The Train,5800000,6800000,0,6800000
"Mar 18, 2011",2011,Winter in Wartime,5800000,542860,9119354,9662214
"Oct 3, 2003",2003,Foolproof,5800000,230312,190709,421021
"Oct 5, 2012",2012,Trade of Innocents,5800000,15091,0,15091
"Sep 8, 2006",2006,Tom yum goong,5700000,12044087,31000000,43044087
"Aug 27, 1999",1999,Stiff Upper Lips,5700000,69582,0,69582
"Sep 7, 2012",2012,The Inbetweeners,5700000,35955,86015365,86051320
"Jul 16, 2010",2010,Valhalla Rising,5700000,30638,700975,731613
"Mar 12, 2003",2003,Bend it Like Beckham,5600000,32543449,42022593,74566042
"Sep 1, 2006",2006,Crossover,5600000,7009668,0,7009668
"Jun 21, 2002",2002,Sunshine State,5600000,3064356,217542,3281898
"Jul 16, 2010",2010,Standing Ovation,5600000,531806,0,531806
"Dec 7, 2012",2012,Khiladi 786,5600000,385422,14298341,14683763
"Jul 9, 2010",2010,[Rec] 2,5600000,27766,18500000,18527766
"Dec 25, 1973",1973,The Sting,5500000,159616327,0,159616327
"Sep 25, 1981",1981,Chariots of Fire,5500000,61558162,307785,61865947
"Feb 25, 2005",2005,Diary of a Mad Black Woman,5500000,50406346,52010,50458356
"Nov 22, 1996",1996,Shine,5500000,35811509,860984,36672493
"Sep 27, 2013",2013,Don Jon,5500000,24477704,16790875,41268579
"Aug 22, 1973",1973,High Plains Drifter,5500000,15700000,0,15700000
"Sep 28, 2018",2018,Hell Fest,5500000,11107431,7011800,18119231
"Jun 6, 2003",2003,Mambo Italiano,5500000,9282750,3117022,12399772
"Jul 20, 2001",2001,Ghost World,5500000,6217849,2543759,8761608
"Dec 14, 2001",2001,Iris,5500000,5580479,0,5580479
"Jun 6, 1980",1980,Galaxina,5500000,4865000,0,4865000
"Nov 26, 2004",2004,Les Choristes,5500000,3629758,79900000,83529758
"Oct 3, 2003",2003,Wonderland,5500000,1060512,0,1060512
"Jul 1, 2005",2005,De battre mon coeur s'est arrÃªtÃ©,5500000,1023424,7566407,8589831
"Apr 1, 2011",2011,Haevnen,5500000,1008098,14859216,15867314
"Oct 21, 2011",2011,Le Havre,5500000,611709,12868487,13480196
"May 17, 2002",2002,Harvard Man,5500000,56653,0,56653
"Jul 15, 2011",2011,Salvation Boulevard,5500000,28468,0,28468
"Jan 23, 2015",2015,R100,5500000,24956,0,24956
"May 5, 2015",2015,Miss Julie,5500000,0,863895,863895
"Dec 31, 2008",2008,Animals,5500000,0,0,0
"Mar 7, 2003",2003,Irreversible,5400000,792200,7341056,8133256
"Feb 26, 2013",2013,Tao Jie,5400000,0,4728896,4728896
"Jan 27, 2006",2006,Rang De Basanti,5300000,2197694,27000000,29197694
"Jul 19, 2013",2013,Grabbers,5300000,0,440821,440821
"Oct 11, 2013",2013,La Vie d'AdÃ¨le â Chapitres 1 & 2,5250000,2450504,20463975,22914479
"Apr 27, 2012",2012,Hodejegerne,5250000,1200010,18988730,20188740
"Aug 3, 2007",2007,The Ten,5250000,769726,16951,786677
"Oct 27, 2000",2000,A Room for Romeo Brass,5250000,20097,0,20097
"Feb 24, 2017",2017,The Girl with all the Gifts,5250000,0,4801837,4801837
"Aug 1, 1944",1944,Wilson,5200000,2000000,0,2000000
"Aug 5, 2005",2005,Saint Ralph,5200000,795126,900000,1695126
"Apr 22, 2011",2011,Dum Maaro Dum,5200000,564489,11068938,11633427
"Oct 3, 1980",1980,Somewhere in Time,5100000,9709597,0,9709597
"Apr 19, 2002",2002,My Big Fat Greek Wedding,5000000,241438208,133451826,374890034
"Feb 24, 2017",2017,Get Out,5000000,176040665,79327286,255367951
"Jan 20, 2017",2017,Split,5000000,138141585,140823221,278964806
"Oct 21, 2011",2011,Paranormal Activity 3,5000000,104028807,103011037,207039844
"Oct 28, 2005",2005,Saw II,5000000,87025093,65900000,152925093
"Sep 13, 2013",2013,Insidious Chapter 2,5000000,83586447,78335068,161921515
"Mar 11, 2016",2016,10 Cloverfield Lane,5000000,72082999,36203423,108286422
"Jul 22, 2016",2016,Lights Out,5000000,67268835,81537675,148806510
"Sep 11, 2015",2015,The Visit,5000000,65206105,33471711,98677816
"Oct 25, 2002",2002,Jackass: The Movie,5000000,64282312,15000000,79282312
"Oct 13, 2017",2017,Happy Death Day,5000000,55683845,69326415,125010260
"Oct 19, 2012",2012,Paranormal Activity 4,5000000,53900335,88917657,142817992
"Oct 24, 2014",2014,Ouija,5000000,50856010,52444622,103300632
"Feb 27, 1987",1987,A Nightmare On Elm Street 3: Dream Warriors,5000000,44793222,0,44793222
"Aug 30, 2013",2013,No se Aceptan Devoluciones,5000000,44467206,56019410,100486616
"Aug 7, 2015",2015,The Gift,5000000,43787265,15191212,58978477
"Jun 23, 2017",2017,The Big Sick,5000000,42872467,11100393,53972860
"May 16, 1975",1975,The Return of the Pink Panther,5000000,41833347,0,41833347
"May 31, 2019",2019,MA,5000000,36049540,8251085,44300625
"Sep 16, 1953",1953,The Robe,5000000,36000000,8303,36008303
"Sep 13, 1991",1991,Freddyâs Dead: The Final Nightmare,5000000,34872033,0,34872033
"Dec 24, 2003",2003,Monster,5000000,34469210,29771603,64240813
"Jan 3, 2014",2014,Paranormal Activity: The Marked Ones,5000000,32462372,58442482,90904854
"Dec 23, 1954",1954,"20,000 Leagues Under the Sea",5000000,28200000,0,28200000
"Apr 11, 2014",2014,Oculus,5000000,27695246,16420250,44115496
"Nov 1, 2013",2013,Dallas Buyers Club,5000000,27298285,33313560,60611845
"Aug 26, 2015",2015,No Escape,5000000,27288872,15555644,42844516
"Oct 3, 1980",1980,The Elephant Man,5000000,26010864,0,26010864
"Feb 27, 2015",2015,The Lazarus Effect,5000000,25801570,12557740,38359310
"Mar 16, 2001",2001,Memento,5000000,25544867,14178229,39723096
"Aug 26, 2011",2011,Our Idiot Brother,5000000,24814830,1046419,25861249
"Mar 9, 2018",2018,The Strangers: Prey at Night,5000000,24431472,5528579,29960051
"Jul 21, 2006",2006,Clerks II,5000000,24148068,3194178,27342246
"Apr 8, 1998",1998,The Players Club,5000000,23047939,0,23047939
"Oct 13, 2000",2000,Billy Elliot,5000000,21995263,87258482,109253745
"Jul 5, 2013",2013,The Way Way Back,5000000,21502690,5351120,26853810
"Aug 29, 2014",2014,"As Above, So Below",5000000,21222315,20601751,41824066
"Apr 1, 2016",2016,Godâs Not Dead 2,5000000,20773069,2778217,23551286
"Dec 17, 1997",1997,The Apostle,5000000,20733485,544285,21277770
"Nov 3, 1982",1982,The Man From Snowy River,5000000,20659423,0,20659423
"Oct 23, 1991",1991,House Party 2,5000000,19438638,0,19438638
"Mar 26, 1999",1999,Doug's 1st Movie,5000000,19421271,0,19421271
"Feb 19, 2016",2016,Race,5000000,19115191,4630581,23745772
"Sep 18, 1981",1981,Mommie Dearest,5000000,19032000,6000000,25032000
"Jan 16, 2015",2015,Still Alice,5000000,18656400,23043212,41699612
"Oct 1, 1988",1988,Halloween 4: The Return of Michael Myers,5000000,17768757,0,17768757
"Sep 2, 2011",2011,Apollo 18,5000000,17686929,8830890,26517819
"Mar 23, 2018",2018,"Paul, Apostle of Christ",5000000,17547999,7981499,25529498
"Oct 10, 2014",2014,Addicted,5000000,17390770,108472,17499242
"Aug 31, 2001",2001,O (Othello),5000000,16017403,0,16017403
"Sep 29, 1995",1995,Halloween: The Curse of Michael Myers,5000000,15126948,0,15126948
"Aug 24, 1954",1954,The Egyptian,5000000,15000000,0,15000000
"Nov 7, 1997",1997,Eve's Bayou,5000000,14843425,0,14843425
"Apr 10, 1981",1981,Nighthawks,5000000,14600000,5000000,19600000
"Jul 28, 1989",1989,Friday the 13th Part VIII: Jason Takes Manhattan,5000000,14343976,0,14343976
"Mar 15, 2013",2013,Spring Breakers,5000000,14124286,17024965,31149251
"Jun 9, 2017",2017,It Comes at Night,5000000,13985117,5735086,19720203
"Mar 15, 2002",2002,Y Tu MamÃ¡ TambiÃ©n,5000000,13649881,20000000,33649881
"Sep 24, 2004",2004,Shaun of the Dead,5000000,13542874,16789511,30332385
"Oct 31, 2008",2008,The Haunting of Molly Hartley,5000000,13442412,1875845,15318257
"Jul 15, 2016",2016,Hillaryâs America: The Secret History of the Democratic Party,5000000,13099931,0,13099931
"Jun 21, 1996",1996,Lone Star,5000000,12961389,0,12961389
"Mar 27, 1986",1986,April Fool's Day,5000000,12947763,0,12947763
"Apr 2, 1982",1982,Diner,5000000,12592907,0,12592907
"Mar 3, 2017",2017,Before I Fall,5000000,12241072,6704610,18945682
"Apr 15, 1983",1983,Lone Wolf McQuade,5000000,12232628,0,12232628
"Mar 13, 2009",2009,Sunshine Cleaning,5000000,12062558,5266779,17329337
"Jan 29, 2016",2016,Fifty Shades of Black,5000000,11686940,10426135,22113075
"Dec 14, 1957",1957,A Farewell To Arms,5000000,11000000,17403,11017403
"Jan 1, 1959",1959,Solomon and Sheba,5000000,11000000,14961,11014961
"Aug 20, 1982",1982,The Beastmaster,5000000,10751126,0,10751126
"Jan 9, 2009",2009,Not Easily Broken,5000000,10572742,160167,10732909
"May 9, 2014",2014,Momsâ Night Out,5000000,10429707,107634,10537341
"Mar 17, 2017",2017,The Belko Experiment,5000000,10166820,1626122,11792942
"Mar 11, 2016",2016,The Perfect Match,5000000,9669521,512529,10182050
"Oct 6, 2000",2000,Digimon: The Movie,5000000,9628751,7000000,16628751
"May 28, 2004",2004,Saved!,5000000,8886160,1320391,10206551
"May 9, 2003",2003,Les invasions barbares,5000000,8460000,17453869,25913869
"Mar 11, 1976",1976,Robin and Marian,5000000,8000000,0,8000000
"Dec 22, 1978",1978,Force 10 from Navarone,5000000,7100000,0,7100000
"Apr 27, 2001",2001,The Forsaken,5000000,6755271,0,6755271
"Sep 21, 2018",2018,Fahrenheit 11/9,5000000,6352306,301409,6653715
"Jul 21, 1989",1989,UHF,5000000,6157157,0,6157157
"May 28, 2010",2010,Sea Rex 3D: Journey to a Prehistoric World,5000000,6096582,10418621,16515203
"Jan 6, 2006",2006,Grandmaâs Boy,5000000,6090172,500000,6590172
"Aug 14, 1998",1998,Slums of Beverly Hills,5000000,5502773,0,5502773
"May 28, 1969",1969,Once Upon a Time in the West,5000000,5321508,56917,5378425
"Jul 13, 2001",2001,Made,5000000,5308707,167353,5476060
"Nov 19, 2004",2004,La mala educaciÃ³n,5000000,5211842,35100000,40311842
"Jun 12, 2009",2009,Moon,5000000,5010163,5665910,10676073
"Sep 11, 2015",2015,90 Minutes in Heaven,5000000,4816142,0,4816142
"Dec 2, 2016",2016,Incarnate,5000000,4799774,4571262,9371036
"May 12, 2006",2006,Keeping Up with the Steins,5000000,4339241,75512,4414753
"Oct 10, 1997",1997,The Sweet Hereafter,5000000,4306697,3644550,7951247
"Aug 6, 2008",2008,Bottle Shock,5000000,4078607,737283,4815890
"Feb 25, 2011",2011,Des Hommes et Des Dieux,5000000,3954651,42308874,46263525
"Aug 27, 1982",1982,Jekyll and Hyde... Together Again,5000000,3707583,0,3707583
"Mar 3, 2017",2017,Table 19,5000000,3614896,1005503,4620399
"Apr 15, 2016",2016,Green Room,5000000,3220371,587132,3807503
"Mar 9, 2018",2018,Thoroughbreds,5000000,3072605,114697,3187302
"Nov 16, 1994",1994,Heavenly Creatures,5000000,3046086,2392034,5438120
"Mar 4, 2016",2016,The Other Side of the Door,5000000,3000342,9904765,12905107
"May 13, 2011",2011,Everything Must Go,5000000,2712131,108879,2821010
"Oct 10, 2014",2014,Kill the Messenger,5000000,2450846,4205859,6656705
"Dec 17, 2010",2010,Rabbit Hole,5000000,2229058,3975976,6205034
"Oct 23, 2015",2015,Jem and the Holograms,5000000,2184640,184297,2368937
"Dec 28, 2016",2016,Paterson,5000000,2141423,8586113,10727536
"Jan 30, 1998",1998,Zero Effect,5000000,2080693,0,2080693
"Apr 24, 1992",1992,A Midnight Clear,5000000,1526697,0,1526697
"Oct 22, 2004",2004,The Machinist,5000000,1082044,7573353,8655397
"Sep 21, 1992",1992,Light Sleeper,5000000,1050861,0,1050861
"Jul 25, 2008",2008,American Teen,5000000,942441,46878,989319
"Sep 12, 2014",2014,Atlas Shrugged: Who Is John Galt?,5000000,851690,0,851690
"Aug 29, 2003",2003,Party Monster,5000000,742898,151132,894030
"Jul 14, 2006",2006,The Oh in Ohio,5000000,418689,229494,648183
"Feb 21, 1996",1996,Bottle Rocket,5000000,407488,0,407488
"Aug 16, 2013",2013,Ain't Them Bodies Saints,5000000,391611,683398,1075009
"Jan 17, 1997",1997,Albino Alligator,5000000,353480,0,353480
"Sep 26, 2014",2014,Jimi: All is By My Side,5000000,340911,586163,927074
"Aug 3, 2007",2007,"Gandhi, My Father",5000000,240425,1774579,2015004
"Apr 25, 2008",2008,Standard Operating Procedure,5000000,228830,103290,332120
"Sep 30, 2011",2011,Tucker & Dale vs. Evil,5000000,223838,5252955,5476793
"Mar 27, 1998",1998,No Looking Back,5000000,143273,0,143273
"Aug 7, 2015",2015,Cop Car,5000000,134552,9106,143658
"Sep 10, 2010",2010,"Lovely, Still",5000000,127564,155123,282687
"Jun 13, 2003",2003,Tycoon,5000000,121016,0,121016
"Jun 4, 1999",1999,Desert Blue,5000000,99147,0,99147
"Feb 27, 2004",2004,Decoys,5000000,84733,12027,96760
"May 30, 2008",2008,Stuck,5000000,67505,0,67505
"Nov 16, 2007",2007,Redacted,5000000,65388,795937,861325
"Oct 17, 2014",2014,Rudderless,5000000,56001,511218,567219
"Jan 28, 2005",2005,Fascination,5000000,16670,66686,83356
"Aug 14, 2009",2009,Grace,5000000,8297,0,8297
"May 15, 2015",2015,Area 51,5000000,7556,0,7556
"Oct 26, 2012",2012,Mientras duermes,5000000,0,9109597,9109597
"Jul 7, 2009",2009,Flying By,5000000,0,4568257,4568257
"Dec 31, 2008",2008,The Cottage,5000000,0,1504960,1504960
"Dec 5, 2014",2014,Dying of the Light,5000000,0,74639,74639
"Sep 2, 2016",2016,Yoga Hosers,5000000,0,22958,22958
"Feb 17, 2009",2009,Dead Like Me: Life After Death,5000000,0,0,0
"Jan 30, 2007",2007,Farce of the Penguins,5000000,0,0,0
"Dec 31, 2010",2010,Psych 9,5000000,0,0,0
"Nov 21, 2014",2014,Reach Me,5000000,0,0,0
"Aug 18, 2014",2014,Henry & Me,5000000,0,0,0
"Jan 27, 2015",2015,Born of War,5000000,0,0,0
"Jan 9, 2015",2015,Let's Kill Ward's Wife,5000000,0,0,0
"Jan 13, 2015",2015,Capricorn One,5000000,0,0,0
"Dec 31, 2011",2011,We Have Your Husband,5000000,0,0,0
"Dec 31, 2012",2012,Should've Been Romeo,5000000,0,0,0
"Dec 31, 2015",2015,Aztec Warrior,5000000,0,0,0
"Sep 25, 2015",2015,Navy SEAL vs. Zombies,5000000,0,0,0
"Mar 15, 2016",2016,The Hatching,5000000,0,0,0
"Oct 27, 2015",2015,Running Forever,5000000,0,0,0
"Jan 23, 2015",2015,Mommy,4900000,3498695,14037309,17536004
"Aug 29, 2008",2008,Obsluhoval jsem anglickÃ©ho krÃ¡le,4900000,617228,6557756,7174984
"Aug 20, 2010",2010,Soul Kitchen,4900000,276901,23070560,23347461
"Aug 17, 2012",2012,The Awakening,4900000,95933,6828388,6924321
"Jan 18, 2008",2008,All Hat,4900000,15198,0,15198
"Nov 20, 1996",1996,Sling Blade,4833610,24475416,9699584,34175000
"Jan 6, 2006",2006,Hostel,4800000,47326473,34914637,82241110
"Jul 19, 2013",2013,Only God Forgives,4800000,775849,3718711,4494560
"Sep 30, 2011",2011,Take Shelter,4750000,1728953,3243063,4972016
"Jan 27, 2006",2006,Tristram Shandy: A Cock and Bull Story,4750000,1253413,1808350,3061763
"Aug 22, 1986",1986,The Texas Chainsaw Massacre 2,4700000,8025872,0,8025872
"Apr 22, 1988",1988,Lady in White,4700000,1705139,0,1705139
"Oct 13, 2006",2006,Driving Lessons,4700000,239962,0,239962
"Dec 31, 2011",2011,Without Men,4700000,0,0,0
"Mar 10, 2015",2015,Treading Water,4700000,0,0,0
"May 23, 1973",1973,Pat Garrett and Billy the Kid,4638783,8000000,3000000,11000000
"Jul 16, 2004",2004,Camping Sauvage,4600000,3479302,0,3479302
"Sep 14, 2012",2012,Barfi,4600000,2804874,33947110,36751984
"Mar 4, 2005",2005,Dear Frankie,4600000,1340891,1758478,3099369
"Dec 29, 2004",2004,The Assassination of Richard Nixon,4600000,708776,4171367,4880143
"Jun 24, 2011",2011,Le nom des gens,4600000,514237,8747474,9261711
"May 28, 2008",2008,Savage Grace,4600000,434417,534388,968805
"Oct 19, 2007",2007,Out of the Blue,4600000,728,731039,731767
"Mar 23, 1984",1984,Police Academy,4500000,81198894,0,81198894
"Mar 9, 1994",1994,Four Weddings and a Funeral,4500000,52700832,190194977,242895809
"Jun 20, 1980",1980,The Blue Lagoon,4500000,47923795,0,47923795
"Aug 13, 1982",1982,Fast Times at Ridgemont High,4500000,27092880,0,27092880
"Sep 28, 1996",1996,Secrets & Lies,4500000,13417292,0,13417292
"Dec 19, 2002",2002,25th Hour,4500000,13084595,12259895,25344490
"Sep 13, 1985",1985,After Hours,4500000,10609321,0,10609321
"Jun 27, 1956",1956,Moby Dick,4500000,10400000,0,10400000
"Mar 25, 2016",2016,The Lobster,4500000,9196278,8823556,18019834
"Oct 4, 1996",1996,Bound,4500000,3802260,3209057,7011317
"Oct 6, 2000",2000,Requiem for a Dream,4500000,3635482,3753751,7389233
"Mar 9, 1962",1962,State Fair,4500000,3500000,0,3500000
"Oct 24, 2008",2008,LÃ¥t den rÃ¤tte komma in,4500000,2122085,10125597,12247682
"Feb 12, 1999",1999,Tango,4500000,1687311,3741076,5428387
"Apr 23, 1986",1986,Salvador,4500000,1500000,0,1500000
"Oct 26, 2001",2001,Donnie Darko,4500000,1480006,6030871,7510877
"Sep 2, 2011",2011,Salvando al Soldado Perez,4500000,1400726,7929739,9330465
"Mar 27, 1998",1998,Karakter,4500000,713413,0,713413
"Aug 19, 2011",2011,Nannerl la soeur de Mozart,4500000,707885,1696754,2404639
"Mar 14, 2003",2003,Spun,4500000,410241,612408,1022649
"Jul 23, 2010",2010,Life During Wartime,4500000,281447,0,281447
"May 4, 2006",2006,Chinjeolhan geumjassi,4500000,211667,23260204,23471871
"Oct 7, 2011",2011,Blackthorn,4500000,200558,1016749,1217307
"May 8, 2015",2015,Maggie,4500000,187112,840648,1027760
"Apr 18, 2003",2003,Lilja 4-ever,4500000,181655,4375327,4556982
"Apr 9, 2010",2010,After.Life,4500000,108596,2373329,2481925
"Feb 22, 2002",2002,Mean Machine,4500000,92723,0,92723
"Aug 31, 2007",2007,Fong juk,4500000,51957,0,51957
"Jul 23, 2010",2010,Spoken Word,4500000,32961,0,32961
"Mar 1, 2013",2013,The Sweeney,4500000,26345,7974021,8000366
"Sep 4, 2014",2014,Falcon Rising,4500000,11774,0,11774
"Jun 25, 2013",2013,Hansel & Gretel Get Baked,4500000,0,0,0
"Nov 7, 2014",2014,Fugly,4500000,0,0,0
"Aug 28, 2015",2015,Zipper,4500000,0,0,0
"Nov 3, 2015",2015,The Final Girls,4500000,0,0,0
"Dec 1, 2017",2017,Daisy Winters,4500000,0,0,0
"Nov 19, 1975",1975,One Flew Over the Cuckoo's Nest,4400000,108981275,16354,108997629
"Jun 25, 1976",1976,Silent Movie,4400000,36145695,0,36145695
"Dec 31, 2016",2016,Airlift (2016),4400000,0,9969237,9969237
"Sep 29, 2015",2015,R.L. Stine's Monsterville: The Cabinet of Souls,4400000,0,0,0
"Jun 6, 2014",2014,Anna,4357373,0,1200000,1200000
"Jun 6, 2003",2003,Whale Rider,4300000,20779666,18594934,39374600
"Jun 13, 2001",2001,Sexy Beast,4300000,6946056,3212299,10158355
"Dec 4, 2009",2009,Paa,4300000,199228,9592054,9791282
"Jul 11, 2012",2012,Snabba Cash,4300000,188870,10023533,10212403
"Oct 19, 1990",1990,Night of the Living Dead,4200000,5835247,0,5835247
"Feb 17, 2006",2006,Nochnoy dozor,4200000,1502188,32411354,33913542
"Aug 13, 2010",2010,Animal Kingdom,4200000,1044039,7034644,8078683
"May 28, 2010",2010,George A. Romero's Survival of the Dead,4200000,101740,0,101740
"Oct 21, 2011",2011,Cargo,4200000,0,313230,313230
"May 23, 2006",2006,High School Musical,4200000,0,0,0
"Mar 6, 1998",1998,Love and Death on Long Island,4030000,2542264,0,2542264
"Mar 19, 1982",1982,Porky's,4000000,109492484,0,109492484
"Feb 5, 1953",1953,Peter Pan,4000000,87400000,0,87400000
"Nov 25, 1992",1992,The Crying Game,4000000,62546695,0,62546695
"Sep 12, 2003",2003,Lost in Translation,4000000,44585453,72499844,117085297
"Apr 20, 1977",1977,Annie Hall,4000000,38251425,0,38251425
"Jan 23, 2015",2015,The Boy Next Door,4000000,36006065,17395873,53401938
"Jan 10, 1952",1952,The Greatest Show on Earth,4000000,36000000,0,36000000
"Oct 27, 1995",1995,Leaving Las Vegas,4000000,31983777,17816223,49800000
"Dec 26, 2001",2001,Monster's Ball,4000000,31273922,12492541,43766463
"Jul 11, 2014",2014,Boyhood,4000000,25379975,31893074,57273049
"Dec 15, 1960",1960,Exodus,4000000,21750000,0,21750000
"Jul 9, 2010",2010,The Kids Are All Right,4000000,20811365,15464104,36275469
"Aug 17, 1979",1979,Life of Brian,4000000,20182359,285946,20468305
"Apr 18, 2014",2014,A Haunted House 2,4000000,17329487,3877374,21206861
"Mar 1, 2013",2013,The Last Exorcism Part II,4000000,15179303,10269404,25448707
"Dec 17, 1974",1974,The Front Page,4000000,15000000,0,15000000
"May 30, 1956",1956,Trapeze,4000000,14400000,0,14400000
"Aug 16, 1985",1985,The Return of the Living Dead,4000000,14237880,0,14237880
"Nov 4, 1988",1988,They Live,4000000,13000000,774,13000774
"Aug 4, 2000",2000,Saving Grace,4000000,12178602,15608247,27786849
"Aug 8, 1963",1963,The Great Escape,4000000,11744471,228090,11972561
"Feb 6, 2004",2004,What the #$'! Do We Know,4000000,10941801,0,10941801
"May 13, 2016",2016,The Darkness,4000000,10753574,144719,10898293
"Jul 28, 2006",2006,Scoop,4000000,10525717,29577545,40103262
"Nov 14, 2001",2001,The Wash,4000000,10097096,0,10097096
"Mar 1, 2000",2000,3 Strikes,4000000,9821335,0,9821335
"Apr 11, 2008",2008,The Visitor,4000000,9427026,9747791,19174817
"Nov 26, 2003",2003,The Cooler,4000000,8291572,2839883,11131455
"Feb 1, 1961",1961,The Misfits,4000000,8200000,0,8200000
"Aug 4, 2006",2006,The Night Listener,4000000,7836393,2934600,10770993
"Feb 3, 1995",1995,The Jerky Boys,4000000,7555256,0,7555256
"Dec 28, 2007",2007,El orfanato,4000000,7159147,72091046,79250193
"May 25, 2007",2007,Bug,4000000,7006708,1296287,8302995
"Oct 11, 2002",2002,The Rules of Attraction,4000000,6525762,5273298,11799060
"Dec 19, 1969",1969,Topaz,4000000,6000000,0,6000000
"Nov 17, 2006",2006,Let's Go to Prison,4000000,4630045,0,4630045
"Dec 25, 1995",1995,Four Rooms,4000000,4301000,0,4301000
"Sep 20, 2002",2002,Secretary,4000000,4046737,5367219,9413956
"Apr 25, 2003",2003,The Real Cancun,4000000,3816594,0,3816594
"Dec 1, 1988",1988,Talk Radio,4000000,3468572,0,3468572
"Jan 31, 1997",1997,Waiting for Guffman,4000000,2922988,0,2922988
"Sep 10, 1999",1999,Love Stinks,4000000,2793776,0,2793776
"Aug 24, 2012",2012,Samsara,4000000,2672413,3294258,5966671
"Jun 22, 2007",2007,You Kill Me,4000000,2426851,1432113,3858964
"Jun 17, 2011",2011,The Art of Getting By,4000000,1430241,558794,1989035
"Sep 16, 2005",2005,Thumbsucker,4000000,1328679,590518,1919197
"Sep 23, 2011",2011,Red State,4000000,1065429,918167,1983596
"Sep 30, 2005",2005,MirrorMask,4000000,864959,108654,973613
"Mar 31, 1987",1987,The Barbarians,4000000,800000,0,800000
"Oct 17, 2012",2012,Holy Motors,4000000,641054,3589372,4230426
"Jun 13, 2014",2014,The Signal,4000000,600896,2064426,2665322
"Feb 28, 2003",2003,Poolhall Junkies,4000000,563711,0,563711
"May 28, 1999",1999,The Loss of Sexual Innocence,4000000,399793,0,399793
"Mar 7, 2014",2014,The Face of Love,4000000,385069,773808,1158877
"Apr 11, 2014",2014,Joe,4000000,373375,0,373375
"Mar 4, 1988",1988,Prison,4000000,354704,0,354704
"May 1, 1998",1998,Shooting Fish,4000000,302204,0,302204
"May 8, 2009",2009,Adoration,4000000,294244,90000,384244
"Aug 4, 2000",2000,Psycho Beach Party,4000000,267972,0,267972
"Jun 7, 2019",2019,Late Night,4000000,246305,0,246305
"Jan 28, 2000",2000,The Big Tease,4000000,185577,0,185577
"Aug 25, 2017",2017,Polina danser sa vie,4000000,165203,788111,953314
"Apr 10, 2015",2015,Desert Dancer,4000000,155271,441064,596335
"Jan 30, 2015",2015,"Guten Tag, Ramon",4000000,154356,4700000,4854356
"Jul 25, 2003",2003,Mondays in the Sun,4000000,146402,0,146402
"Jun 19, 2015",2015,Manglehorn,4000000,132270,665169,797439
"Apr 2, 2010",2010,Tau ming chong,4000000,129078,38770714,38899792
"Apr 1, 2011",2011,Trust,4000000,120016,0,120016
"Dec 22, 2000",2000,An Everlasting Piece,4000000,75078,0,75078
"Mar 26, 1999",1999,Among Giants,4000000,64359,0,64359
"Jul 16, 1999",1999,The Velocity of Gary,4000000,34145,0,34145
"Apr 22, 2011",2011,Stake Land,4000000,33245,646237,679482
"Feb 27, 2015",2015,Praia do Futuro,4000000,20620,740058,760678
"Dec 27, 2002",2002,Sonny,4000000,17639,0,17639
"Jun 20, 1997",1997,The Last Time I Committed Suicide,4000000,12836,0,12836
"Apr 18, 2014",2014,13 Sins,4000000,9134,38418,47552
"Nov 18, 2011",2011,Another Happy Day,4000000,9120,969407,978527
"Feb 22, 2013",2013,Inescapable,4000000,4327,0,4327
"Dec 31, 2017",2017,Perfectos Desconocidos,4000000,0,31166312,31166312
"Dec 31, 2013",2013,Geograf globus propil,4000000,0,4454853,4454853
"Mar 20, 2012",2012,A Lonely Place to Die,4000000,0,442550,442550
"Dec 31, 2003",2003,Nothing,4000000,0,63180,63180
"Jun 1, 2012",2012,The Loved Ones,4000000,0,12302,12302
"Nov 9, 1972",1972,1776,4000000,0,0,0
"Nov 15, 1930",1930,Hell's Angels,4000000,0,0,0
"Aug 26, 2008",2008,Purple Violets,4000000,0,0,0
"Nov 9, 2012",2012,Replicas,4000000,0,0,0
"Dec 31, 2012",2012,The Helpers,4000000,0,0,0
"Dec 31, 2015",2015,The Veil,4000000,0,0,0
"Jul 11, 2014",2014,The Perfect Wave,4000000,0,0,0
"Dec 31, 2012",2012,How to Fall in Love,4000000,0,0,0
"Sep 8, 2015",2015,Chain of Command,4000000,0,0,0
"Dec 15, 1939",1939,Gone with the Wind,3900000,198680470,191844722,390525192
"Dec 12, 1966",1966,A Man for All Seasons,3900000,28350000,0,28350000
"Dec 30, 1925",1925,Ben-Hur: A Tale of the Christ,3900000,9000000,0,9000000
"Jan 1, 1976",1976,Network,3800000,23689877,0,23689877
"Jan 14, 2011",2011,Down for Life,3800000,41914,0,41914
"Apr 30, 2010",2010,The Good Heart,3800000,20930,320000,340930
"Apr 7, 1965",1965,Major Dundee,3800000,14873,0,14873
"Oct 5, 2018",2018,Hevi reissu,3800000,10153,0,10153
"Dec 31, 1974",1974,The Taking of Pelham One Two Three,3800000,0,0,0
"May 17, 1950",1950,Annie Get Your Gun,3768785,8000000,0,8000000
"Aug 11, 2006",2006,Casa de Areia,3750000,539285,638890,1178175
"Nov 5, 2010",2010,Four Lions,3750000,310007,2126104,2436111
"Feb 19, 2010",2010,Defendor,3750000,44462,0,44462
"May 13, 1970",1970,The Ballad of Cable Hogue,3716946,3500000,1500000,5000000
"May 20, 1948",1948,The Pirate,3700000,2956000,0,2956000
"Nov 21, 2006",2006,The History Boys,3700000,2730296,10717702,13447998
"Nov 3, 2006",2006,Unknown,3700000,26403,3328645,3355048
"May 25, 1969",1969,Midnight Cowboy,3600000,44785053,0,44785053
"Oct 10, 2008",2008,Billy: The Early Years of Billy Graham,3600000,320896,0,320896
"Dec 31, 2017",2017,UtÃ¸ya 22. juli,3600000,0,173156,173156
"Jul 4, 1980",1980,Airplane!,3500000,83453539,0,83453539
"Jan 1, 1970",1970,M*A*S*H,3500000,81600000,0,81600000
"Aug 13, 1997",1997,The Full Monty,3500000,45950122,215299261,261249383
"Apr 13, 2018",2018,Truth or Dare,3500000,41411015,53716329,95127344
"May 26, 1993",1993,Menace II Society,3500000,27731527,0,27731527
"Apr 26, 1995",1995,Friday,3500000,27467564,469214,27936778
"Feb 19, 2016",2016,The Witch,3500000,25138705,15315815,40454520
"Feb 2, 2018",2018,Winchester,3500000,25091816,19286224,44378040
"Dec 6, 2002",2002,Empire,3500000,17504595,990849,18495444
"Feb 22, 2013",2013,Dark Skies,3500000,17418667,10285444,27704111
"Jan 19, 2018",2018,Forever My Girl,3500000,16376066,0,16376066
"May 1, 1987",1987,Creepshow 2,3500000,14000000,0,14000000
"Dec 14, 1967",1967,In Cold Blood,3500000,13000000,7551,13007551
"Jul 18, 1959",1959,The Nun's Story,3500000,12800000,0,12800000
"Jun 21, 1972",1972,Frenzy,3500000,12600000,0,12600000
"Feb 23, 1966",1966,Harper,3500000,12000000,0,12000000
"May 27, 1998",1998,I Got the Hook-Up!,3500000,10317779,0,10317779
"Aug 23, 1996",1996,She's the One,3500000,9482579,4312474,13795053
"Jan 1, 1980",1980,Terror Train,3500000,8000000,0,8000000
"Nov 6, 1998",1998,Gods and Monsters,3500000,6451628,0,6451628
"Apr 16, 2010",2010,El secreto de sus ojos,3500000,6391436,34136283,40527719
"Mar 13, 1987",1987,Evil Dead II,3500000,5923044,3133,5926177
"Jun 30, 1985",1985,Day of the Dead,3500000,5804262,28200000,34004262
"May 18, 2018",2018,First Reformed,3500000,3448256,426516,3874772
"Jun 29, 2001",2001,Pootie Tang,3500000,3293258,0,3293258
"Dec 2, 2016",2016,Believe,3500000,890303,0,890303
"Apr 19, 2000",2000,La otra conquista,3500000,886410,0,886410
"Sep 30, 2016",2016,American Honey,3500000,663247,1948503,2611750
"Mar 18, 2016",2016,The Bronze,3500000,615816,0,615816
"Jun 10, 2011",2011,Trolljegeren,3500000,253444,5453194,5706638
"Sep 14, 2007",2007,Ira and Abby,3500000,221096,0,221096
"Jan 8, 2016",2016,The Masked Saint,3500000,182695,0,182695
"Feb 17, 2006",2006,Winter Passing,3500000,107492,6291,113783
"Mar 25, 2005",2005,D.E.B.S.,3500000,96793,0,96793
"Jun 3, 2016",2016,Time to Choose,3500000,29233,0,29233
"Jun 26, 2009",2009,Surveillance,3500000,27349,1369046,1396395
"Sep 17, 1999",1999,Taxman,3500000,9871,0,9871
"Dec 31, 2011",2011,The Kick,3500000,0,40622,40622
"Jun 30, 2009",2009,The Betrayed,3500000,0,0,0
"Oct 1, 2006",2006,The Secret,3500000,0,0,0
"Jun 28, 2011",2011,2:13,3500000,0,0,0
"Jan 29, 2013",2013,"Batman: The Dark Knight Returns, Part 2",3500000,0,0,0
"Mar 11, 2014",2014,In the Name of the King III,3500000,0,0,0
"Mar 4, 2014",2014,Wicked Blood,3500000,0,0,0
"Jun 5, 2015",2015,Dawn Patrol,3500000,0,0,0
"May 17, 2013",2013,Jagten,3450000,687185,17622608,18309793
"Sep 1, 2015",2015,Lords of London,3440000,0,0,0
"Jun 24, 2005",2005,La marche de l'empereur,3400000,77437223,55839136,133276359
"Dec 23, 1977",1977,High Anxiety,3400000,31063038,0,31063038
"Oct 21, 2011",2011,Margin Call,3400000,5353586,15079641,20433227
"Sep 26, 2008",2008,Choke,3400000,2926565,1197712,4124277
"Apr 23, 2004",2004,L\'incomparable mademoiselle C.,3400000,493905,0,493905
"Jul 11, 2008",2008,August,3400000,12636,0,12636
"Mar 3, 2015",2015,To Write Love On Her Arms,3400000,0,0,0
"Feb 16, 1956",1956,Carousel,3380000,0,3604,3604
"Oct 10, 2014",2014,Whiplash,3300000,13092006,25877031,38969037
"Oct 26, 2007",2007,Bella,3300000,8093373,4312100,12405473
"Jan 17, 2003",2003,Cidade de Deus,3300000,7563397,24495898,32059295
"May 5, 2000",2000,Human Traffic,3300000,104257,5318483,5422740
"Dec 29, 2006",2006,The Dead Girl,3300000,19875,0,19875
"Jan 20, 2015",2015,The Opposite Sex,3300000,0,50206,50206
"Nov 18, 1983",1983,A Christmas Story,3250000,20605209,0,20605209
"Aug 20, 1982",1982,Class of 1984,3250000,6965361,0,6965361
"Jan 30, 2009",2009,Entre les murs,3250000,3766810,30347257,34114067
"Oct 29, 1999",1999,Dreaming of Joseph Lees,3250000,7680,0,7680
"Jun 12, 1968",1968,Rosemary's Baby,3200000,33395426,0,33395426
"Jul 6, 2018",2018,Sorry to Bother You,3200000,17493096,792464,18285560
"Apr 22, 1962",1962,The Man Who Shot Liberty Valance,3200000,8000000,0,8000000
"Jul 16, 2004",2004,Maria Full of Grace,3200000,6529624,7911534,14441158
"Jun 3, 2011",2011,Beginners,3200000,5790894,8523513,14314407
"Apr 22, 2016",2016,The Meddler,3200000,4267219,1259723,5526942
"Jul 29, 2009",2009,Adam,3200000,2283291,551194,2834485
"Sep 22, 2006",2006,Feast,3200000,56131,634741,690872
"Dec 20, 1946",1946,Itâs a Wonderful Life,3180000,6600000,4168908,10768908
"Jul 19, 1996",1996,Trainspotting,3100000,16501785,55057186,71558971
"Apr 12, 2013",2013,Antiviral,3100000,0,123407,123407
"Jul 28, 1978",1978,National Lampoon's Animal House,3000000,141600000,0,141600000
"Oct 20, 2010",2010,Paranormal Activity 2,3000000,84752907,92759125,177512032
"Aug 28, 2015",2015,War Room,3000000,67790117,6185122,73975239
"Jun 7, 2013",2013,The Purge,3000000,64473115,26793466,91266581
"Dec 22, 1964",1964,Goldfinger,3000000,51100000,73800000,124900000
"Oct 12, 2012",2012,Sinister,3000000,48086903,39640904,87727807
"Aug 18, 2000",2000,The Original Kings of Comedy,3000000,38168022,68316,38236338
"Dec 18, 1957",1957,The Bridge on the River Kwai,3000000,33300000,0,33300000
"Jan 1, 1978",1978,Coming Home,3000000,32653000,0,32653000
"Nov 20, 1998",1998,Waking Ned Devine,3000000,24793251,30400000,55193251
"Aug 1, 1997",1997,Air Bud,3000000,24646936,3141713,27788649
"Oct 11, 2002",2002,Bowling for Columbine,3000000,21576018,36664469,58240487
"Nov 1, 1985",1985,A Nightmare on Elm Street Part 2: Freddy's Revenge,3000000,21163999,0,21163999
"Mar 7, 1986",1986,A Room with a View,3000000,20966644,0,20966644
"Jun 10, 1975",1975,Love and Death,3000000,20123742,0,20123742
"Aug 1, 1986",1986,Friday the 13th Part VI: Jason Lives,3000000,19472057,0,19472057
"Aug 2, 2002",2002,Martin Lawrence Live: RunTelDat,3000000,19184820,0,19184820
"Jun 15, 1960",1960,The Apartment,3000000,18600000,6000000,24600000
"Sep 20, 1958",1958,Cat on a Hot Tin Roof,3000000,17570324,0,17570324
"May 26, 1970",1970,Beneath the Planet of the Apes,3000000,17489009,0,17489009
"Apr 6, 2001",2001,Pokemon 3: The Movie,3000000,17052128,51400000,68452128
"Aug 13, 1993",1993,Jason Goes to Hell: The Final Friday,3000000,15935068,0,15935068
"Apr 27, 1990",1990,Spaced Invaders,3000000,15000000,0,15000000
"Apr 9, 1976",1976,Family Plot,3000000,13200000,0,13200000
"Jul 16, 1966",1966,Torn Curtain,3000000,13000000,0,13000000
"Jun 1, 2018",2018,Upgrade,3000000,11977130,4576155,16553285
"Mar 3, 2006",2006,Dave Chappelle's Block Party,3000000,11718595,333329,12051924
"Oct 25, 1985",1985,Krush Groove,3000000,11052713,0,11052713
"Jul 7, 1960",1960,Elmer Gantry,3000000,10400000,0,10400000
"May 8, 2009",2009,Next Day Air,3000000,10027047,145472,10172519
"Dec 19, 1961",1961,Judgment at Nuremberg,3000000,10000000,0,10000000
"Nov 4, 1998",1998,Belly,3000000,9639390,0,9639390
"May 12, 1999",1999,Trippinâ,3000000,9017070,0,9017070
"Aug 26, 1948",1948,Red River,3000000,9012000,0,9012000
"Aug 8, 2001",2001,The Deep End,3000000,8823109,1158526,9981635
"May 24, 2013",2013,Before Midnight,3000000,8110621,15141309,23251930
"Nov 20, 1987",1987,Teen Wolf Too,3000000,7888000,0,7888000
"Jul 31, 2009",2009,The Collector,3000000,7712114,2761722,10473836
"Jul 8, 1988",1988,Phantasm II,3000000,7282851,0,7282851
"Oct 27, 2017",2017,Let There Be Light,3000000,7233471,7838,7241309
"Apr 7, 2006",2006,Phat Girlz,3000000,7061128,239987,7301115
"Oct 1, 2004",2004,Woman Thou Art Loosed,3000000,6879730,0,6879730
"Oct 18, 2002",2002,Real Women Have Curves,3000000,5853194,1924596,7777790
"Aug 28, 1981",1981,Gallipoli,3000000,5732587,0,5732587
"Apr 28, 2006",2006,Water,3000000,5529144,5793429,11322573
"Jul 22, 2016",2016,Donât Think Twice,3000000,4417983,0,4417983
"Jun 24, 2016",2016,Swiss Army Man,3000000,4210454,1626657,5837111
"Apr 14, 2000",2000,East is East,3000000,4170647,26267988,30438635
"Sep 1, 2000",2000,Whipped,3000000,4142507,0,4142507
"Feb 28, 1997",1997,Kama Sutra,3000000,4109095,0,4109095
"May 17, 2013",2013,Frances Ha,3000000,4067398,7195371,11262769
"Apr 30, 2010",2010,Please Give,3000000,4033574,536604,4570178
"Jun 30, 1971",1971,Willy Wonka & the Chocolate Factory,3000000,4000000,0,4000000
"Sep 24, 1993",1993,Warlock: The Armageddon,3000000,3902679,0,3902679
"Apr 18, 1997",1997,8 Heads in a Duffel Bag,3000000,3602884,400000,4002884
"Sep 13, 1978",1978,Days of Heaven,3000000,3446749,214131,3660880
"May 24, 2002",2002,Thirteen Conversations About One Thing,3000000,3287435,418488,3705923
"Apr 22, 2016",2016,Compadres,3000000,3127773,4317271,7445044
"Feb 19, 1999",1999,Jawbreaker,3000000,3076820,0,3076820
"Aug 9, 1996",1996,Basquiat,3000000,2962051,0,2962051
"Feb 24, 2006",2006,Tsotsi,3000000,2912606,8624933,11537539
"Apr 9, 2010",2010,Letters to God,3000000,2848587,388865,3237452
"Oct 16, 1998",1998,Happiness,3000000,2746453,3000000,5746453
"Apr 4, 2003",2003,DysFunkTional Family,3000000,2255000,0,2255000
"Sep 19, 2014",2014,Tusk,3000000,1821983,65571,1887554
"May 12, 2017",2017,The Wall,3000000,1803064,2692198,4495262
"Oct 24, 2003",2003,Elephant,3000000,1266955,8784561,10051516
"Apr 6, 2012",2012,Damsels in Distress,3000000,1007535,316764,1324299
"Mar 25, 2005",2005,Oldboy,3000000,707391,5532332,6239723
"May 6, 2011",2011,Hobo with a Shotgun,3000000,703372,131581,834953
"May 8, 2015",2015,The D Train,3000000,669688,102678,772366
"Sep 7, 2012",2012,Bachelorette,3000000,446770,12130631,12577401
"Jan 15, 2010",2010,Fish Tank,3000000,374675,5547617,5922292
"Sep 5, 2008",2008,Everybody Wants to Be Italian,3000000,351416,0,351416
"Sep 9, 2011",2011,Creature,3000000,331000,0,331000
"Dec 9, 2016",2016,The Bounce Back,3000000,321910,99494,421404
"Aug 23, 1996",1996,Freeway,3000000,295493,0,295493
"Oct 6, 2006",2006,Love's Abiding Joy,3000000,252726,0,252726
"Feb 12, 1993",1993,Dead Alive,3000000,242623,0,242623
"Oct 1, 2010",2010,Chain Letter,3000000,205842,816611,1022453
"Mar 2, 2012",2012,Tim and Eric's Billion Dollar Movie,3000000,201436,22216,223652
"Nov 9, 2007",2007,Holly,3000000,163069,0,163069
"Mar 26, 2010",2010,The Eclipse,3000000,133411,0,133411
"Mar 21, 2008",2008,The Grand,3000000,115879,0,115879
"Mar 17, 2006",2006,Sommersturm,3000000,95204,0,95204
"Aug 15, 2014",2014,Fort McCoy,3000000,78948,0,78948
"Aug 4, 1999",1999,The Gambler,3000000,51773,50000,101773
"Oct 13, 2000",2000,Just Looking,3000000,39852,0,39852
"Sep 4, 2015",2015,Before We Go,3000000,37151,446787,483938
"Jan 13, 2012",2012,The Divide,3000000,18000,138362,156362
"Sep 9, 2011",2011,Tanner Hall,3000000,5073,0,5073
"Sep 30, 2005",2005,My Big Fat Independent Movie,3000000,4655,0,4655
"Oct 10, 2017",2017,Demonic,3000000,0,4668109,4668109
"Apr 15, 2008",2008,Ã l\'intÃ©rieur,3000000,0,895932,895932
"Jun 27, 2014",2014,They Came Together,3000000,0,82780,82780
"May 21, 2013",2013,Open Road,3000000,0,47469,47469
"Jul 28, 1951",1951,Alice in Wonderland,3000000,0,0,0
"Oct 1, 2010",2010,Barry Munday,3000000,0,0,0
"Dec 31, 2009",2009,The Deported,3000000,0,0,0
"Dec 31, 2009",2009,Chicago Overcoat,3000000,0,0,0
"Sep 13, 2011",2011,Never Back Down 2: The Beatdown,3000000,0,0,0
"Dec 31, 2015",2015,AWOL-72,3000000,0,0,0
"Jan 15, 2013",2013,30 Nights Of Paranormal Activity With The Devil Inside The Girl With The Dragon Tattoo,3000000,0,0,0
"Feb 6, 2015",2015,Enter the Dangerous Mind,3000000,0,0,0
"Mar 17, 2015",2015,Something Wicked,3000000,0,0,0
"Sep 18, 1967",1967,Point Blank,3000000,0,0,0
"Oct 27, 2014",2014,Iguana,3000000,0,0,0
"Dec 31, 2009",2009,Four Single Fathers,3000000,0,0,0
"Aug 14, 2015",2015,Amnesiac,3000000,0,0,0
"Dec 31, 2015",2015,Unnatural,3000000,0,0,0
"Dec 11, 2015",2015,Close Range,3000000,0,0,0
"Jan 18, 1946",1946,The Harvey Girls,2931000,4100000,0,4100000
"Feb 15, 1950",1950,Cinderella,2900000,85000000,178591415,263591415
"Nov 20, 1998",1998,Central do Brasil,2900000,5969553,11036605,17006158
"Dec 19, 1961",1961,Pocketful of Miracles,2900000,5000000,0,5000000
"Mar 24, 2006",2006,Boynton Beach Club,2900000,3127472,0,3127472
"Oct 1, 2010",2010,Freakonomics,2900000,101270,71597,172867
"Aug 19, 2011",2011,Griff the Invisible,2900000,20778,5157,25935
"Mar 29, 1959",1959,Some Like it Hot,2883848,25000000,19542,25019542
"Jun 10, 2005",2005,High Tension,2850000,3681066,2754196,6435262
"Dec 15, 1974",1974,Young Frankenstein,2800000,86300000,0,86300000
"Jun 25, 1976",1976,The Omen,2800000,48570885,0,48570885
"Jul 22, 2005",2005,Hustle & Flow,2800000,22202809,1388974,23591783
"May 13, 1988",1988,Friday the 13th Part VII: The New Blood,2800000,19170001,0,19170001
"Sep 15, 2006",2006,Artie Lange's Beer League,2800000,475000,0,475000
"Aug 25, 1939",1939,The Wizard of Oz,2777000,34063405,242071,34305476
"Feb 15, 2008",2008,Diary of the Dead,2750000,952620,4441827,5394447
"Oct 17, 1979",1979,The Black Stallion,2700000,37799643,0,37799643
"Jun 13, 1997",1997,Ulee's Gold,2700000,9054736,6545264,15600000
"Oct 26, 2018",2018,Indivisible,2700000,3511417,76888,3588305
"Sep 1, 2006",2006,Lage Raho Munna Bhai,2700000,2217561,29300000,31517561
"Dec 31, 2015",2015,Sardaar Ji,2700000,0,8200000,8200000
"Dec 31, 2008",2008,Rejsen til Saturn,2700000,0,5377665,5377665
"Jun 12, 1963",1963,Donovan's Reef,2686000,6600000,0,6600000
"Jan 12, 1956",1956,Diane,2660000,0,0,0
"Jan 16, 1998",1998,The Dress,2650000,16556,0,16556
"Dec 24, 1943",1943,A Guy Named Joe,2627000,5363000,0,5363000
"Feb 7, 1974",1974,Blazing Saddles,2600000,119500000,0,119500000
"Apr 13, 1984",1984,Friday the 13th Part IV: The Final Chapter,2600000,32980880,0,32980880
"May 2, 2014",2014,Ida,2600000,3827060,11471295,15298355
"Jan 1, 1987",1987,Maurice,2600000,3147950,50358,3198308
"Jul 9, 2004",2004,Riding Giants,2600000,2276368,1015965,3292333
"Dec 12, 2008",2008,Los CronocrÃ­menes,2600000,39127,525347,564474
"Dec 31, 2011",2011,La Cara Oculta,2600000,0,7033931,7033931
"Dec 7, 2007",2007,Timber Falls,2600000,0,71248,71248
"Dec 31, 2008",2008,Silver Medalist,2600000,0,0,0
"Apr 1, 2011",2011,"Fat, Sick & Nearly Dead",2600000,0,0,0
"Apr 10, 1952",1952,Singin' in the Rain,2540000,7200000,0,7200000
"Jan 11, 2013",2013,A Haunted House,2500000,40041683,19880875,59922558
"Jul 13, 2012",2012,2016: Obamaâs America,2500000,33349941,0,33349941
"Jul 3, 2013",2013,Kevin Hart: Let Me Explain,2500000,32244051,83204,32327255
"Jul 28, 2004",2004,Garden State,2500000,26782316,9246486,36028802
"Oct 4, 1996",1996,That Thing You Do!,2500000,25857416,8700000,34557416
"Oct 30, 1981",1981,Halloween II,2500000,25533818,0,25533818
"Oct 22, 1982",1982,Halloween 3: Season of the Witch,2500000,14400000,0,14400000
"Oct 1, 2008",2008,Religulous,2500000,13011160,870157,13881317
"Jan 1, 1971",1971,Escape from the Planet of the Apes,2500000,12300000,0,12300000
"May 29, 1963",1963,Hud,2500000,10000000,0,10000000
"Aug 2, 2013",2013,The Spectacular Now,2500000,6852971,63980,6916951
"Sep 29, 1991",1991,My Own Private Idaho,2500000,6401336,0,6401336
"Jan 27, 1995",1995,Before Sunrise,2500000,5274005,416215,5690220
"Jun 24, 2016",2016,Hunt for the Wilderpeople,2500000,5205471,18640062,23845533
"Aug 17, 2012",2012,Robot & Frank,2500000,3317468,1616888,4934356
"Oct 3, 2003",2003,Sur Le Seuil,2500000,2013052,0,2013052
"Jun 16, 2000",2000,Jesus' Son,2500000,1282084,405464,1687548
"May 27, 2005",2005,Saving Face,2500000,1187266,82439,1269705
"Jun 20, 2008",2008,Brick Lane,2500000,1094998,2743488,3838486
"Mar 1, 2013",2013,The Lost Medallion: The Adventures of Billy Stone,2500000,549632,0,549632
"Sep 26, 2003",2003,My Life Without Me,2500000,432360,11834915,12267275
"Mar 31, 2006",2006,Marilyn Hotchkiss' Ballroom Dancing and Charm School,2500000,349132,148063,497195
"Apr 1, 2011",2011,Super,2500000,327716,266217,593933
"Nov 14, 2008",2008,Fuel,2500000,174255,0,174255
"Apr 9, 2010",2010,Valley of the Hearts Delight,2500000,118666,0,118666
"Oct 31, 2008",2008,The Other End of the Line,2500000,115504,391942,507446
"Jun 18, 2010",2010,8: The Mormon Proposition,2500000,100280,0,100280
"Apr 17, 2009",2009,Sleep Dealer,2500000,80136,28771,108907
"Aug 24, 2007",2007,Eye of the Dolphin,2500000,72210,50,72260
"Aug 16, 2013",2013,Underdogs,2500000,35017,1357632,1392649
"Sep 8, 2000",2000,Anatomie,2500000,9598,0,9598
"Dec 31, 2009",2009,The Calling,2500000,0,0,0
"Jun 21, 2013",2013,Alien Uprising,2500000,0,0,0
"Dec 31, 2010",2010,Christmas Mail,2500000,0,0,0
"Jul 3, 2015",2015,Stung,2500000,0,0,0
"Sep 1, 2017",2017,Sky Sharks,2500000,0,0,0
"Oct 13, 2015",2015,8 Days,2500000,0,0,0
"Sep 2, 2016",2016,Antibirth,2500000,0,0,0
"Feb 2, 2016",2016,The Rise of the Krays,2500000,0,0,0
"Dec 31, 2014",2014,Not Safe For Work,2500000,0,0,0
"May 13, 2011",2011,Go For It!,2450000,180237,2121,182358
"Oct 16, 1996",1996,Get on the Bus,2400000,5691854,0,5691854
"Jan 5, 2007",2007,Thr3e,2400000,1008849,411569,1420418
"Sep 1, 2006",2006,Idiocracy,2400000,444093,56203,500296
"Dec 31, 2009",2009,NiktÃ©,2400000,0,1333891,1333891
"Nov 14, 2014",2014,Always Woodstock,2400000,0,0,0
"Jul 25, 2007",2007,This is England,2380000,327919,8411657,8739576
"Jun 27, 1944",1944,Bathing Beauty,2361000,3500000,0,3500000
"Mar 20, 2015",2015,Do You Believe?,2300000,12985600,1319331,14304931
"Jul 17, 1951",1951,Show Boat,2300000,11000000,0,11000000
"May 1, 1998",1998,"Dancer, Texas Pop. 81",2300000,574838,0,574838
"Sep 5, 2014",2014,Frontera,2300000,59696,0,59696
"Aug 26, 2011",2011,Redemption Road,2300000,29384,0,29384
"Apr 15, 2015",2015,The Toxic Avenger Part II,2300000,0,0,0
"Jan 19, 2016",2016,Eden,2300000,0,0,0
"Jun 19, 1987",1987,The Brave Little Toaster,2300000,0,0,0
"Feb 9, 1940",1940,Pinocchio,2289247,84300000,0,84300000
"Nov 13, 1940",1940,Fantasia,2280000,83320000,0,83320000
"Aug 13, 1982",1982,Friday the 13th Part 3,2250000,36690067,0,36690067
"Oct 9, 1971",1971,The French Connection,2200000,41158757,0,41158757
"Mar 22, 1985",1985,Friday the 13th Part V: A New Beginning,2200000,21930418,0,21930418
"Feb 9, 2007",2007,The Last Sin Eater,2200000,388390,0,388390
"Dec 31, 2008",2008,Impact Point,2200000,0,0,0
"May 3, 1945",1945,The Valley of Decision,2160000,9132000,0,9132000
"Dec 31, 2005",2005,Chicken Tikka Masala,2160000,0,37865,37865
"Oct 7, 2008",2008,Jack Brooks: Monster Slayer,2150000,0,0,0
"Nov 21, 1946",1946,The Best Years of Our Lives,2100000,23600000,0,23600000
"Jul 13, 2001",2001,Bully,2100000,881824,500000,1381824
"May 29, 2002",2002,Elling,2100000,313436,0,313436
"Oct 16, 2016",2016,Mi America,2100000,3330,0,3330
"Jul 14, 2009",2009,[Rec],2100000,0,23266821,23266821
"Dec 31, 2012",2012,Infected,2100000,0,0,0
"Dec 31, 2010",2010,Lies in Plain Sight,2100000,0,0,0
"Oct 6, 2015",2015,The Timber,2100000,0,0,0
"Jan 19, 2016",2016,Sharkskin,2100000,0,0,0
"Sep 30, 2011",2011,Courageous,2000000,34522221,663663,35185884
"Apr 8, 1964",1964,From Russia With Love,2000000,24800000,54100000,78900000
"May 21, 1982",1982,Mad Max 2: The Road Warrior,2000000,24600832,0,24600832
"Aug 15, 1946",1946,Notorious,2000000,24464742,0,24464742
"Aug 2, 1967",1967,In the Heat of the Night,2000000,24379978,27669,24407647
"Dec 17, 1973",1973,Sleeper,2000000,18344729,0,18344729
"Aug 11, 1972",1972,Everything You Always Wanted to Know,2000000,18016290,0,18016290
"Mar 13, 2015",2015,It Follows,2000000,14674077,8576678,23250755
"Jul 13, 2018",2018,Eighth Grade,2000000,13539710,801306,14341016
"Dec 25, 1962",1962,To Kill A Mockingbird,2000000,13129846,0,13129846
"Mar 9, 2012",2012,Silent House,2000000,12739737,3871023,16610760
"Oct 8, 1999",1999,Boys Don't Cry,2000000,11540607,9200393,20741000
"Feb 9, 2007",2007,Das Leben der Anderen,2000000,11284657,69912390,81197047
"Apr 8, 2016",2016,Hardcore Henry,2000000,9252038,7935396,17187434
"Jun 13, 1962",1962,Lolita,2000000,9250000,0,9250000
"Aug 30, 1940",1940,Boom Town,2000000,9172000,0,9172000
"Nov 11, 1947",1947,Gentleman's Agreement,2000000,7800000,0,7800000
"Sep 25, 1961",1961,The Hustler,2000000,7600000,0,7600000
"Dec 31, 1986",1986,Witchboard,2000000,7369373,0,7369373
"Nov 26, 2003",2003,Les Triplettes de Belleville,2000000,7301288,10101880,17403168
"Jun 26, 1998",1998,Smoke Signals,2000000,6719300,1037317,7756617
"Jun 11, 2010",2010,Winter's Bone,2000000,6531503,9600048,16131551
"Oct 10, 2014",2014,Meet the Mormons,2000000,6047363,1808,6049171
"Aug 15, 2003",2003,American Splendor,2000000,6003587,2682045,8685632
"Oct 6, 2017",2017,The Florida Project,2000000,5904366,5390958,11295324
"Aug 25, 2017",2017,All Saints,2000000,5802208,139786,5941994
"Jul 2, 2004",2004,Before Sunset,2000000,5792822,5424524,11217346
"Mar 30, 2001",2001,Amores Perros,2000000,5383834,15500000,20883834
"Aug 20, 2003",2003,Thirteen,2000000,4601043,4904953,9505996
"Jan 23, 2004",2004,Touching the Void,2000000,4593598,10802927,15396525
"Oct 8, 2010",2010,Inside Job,2000000,4311834,3487423,7799257
"May 24, 1938",1938,Alexander's Ragtime Band,2000000,4000000,0,4000000
"Jun 17, 2005",2005,Me and You and Everyone We Know,2000000,3885134,5730330,9615464
"Aug 28, 2015",2015,We Are Your Friends,2000000,3591417,6561998,10153415
"Nov 10, 2006",2006,Harsh Times,2000000,3337931,2887373,6225304
"Mar 3, 2000",2000,Ghost Dog: The Way of the Samurai,2000000,3330230,7342262,10672492
"Sep 18, 2015",2015,Captive,2000000,2583301,208672,2791973
"Aug 2, 2002",2002,Full Frontal,2000000,2512846,925958,3438804
"Jun 8, 2018",2018,Hearts Beat Loud,2000000,2386254,34708,2420962
"Jan 20, 2017",2017,The Resurrection of Gavin Stone,2000000,2303792,0,2303792
"Dec 25, 2008",2008,Waltz with Bashir,2000000,2283849,11628440,13912289
"Jun 28, 2006",2006,Strangers with Candy,2000000,2072645,5199,2077844
"Mar 1, 1992",1992,Night on Earth,2000000,2015000,7893,2022893
"Jan 29, 1993",1993,Nemesis,2000000,2001124,0,2001124
"Oct 4, 2006",2006,Shortbus,2000000,1985292,0,1985292
"May 2, 2008",2008,Son of Rambow: A Home Movie,2000000,1785505,9477758,11263263
"Sep 12, 2003",2003,"The Book of Mormon Movie, Volume 1: The Journey",2000000,1660865,0,1660865
"May 12, 2000",2000,Hamlet,2000000,1577287,842382,2419669
"Aug 7, 2015",2015,The Diary of a Teenage Girl,2000000,1477002,802957,2279959
"Jul 27, 2007",2007,No End In Sight,2000000,1433319,0,1433319
"Apr 25, 2014",2014,Locke,2000000,1370646,717744,2088390
"Apr 30, 1999",1999,Get Real,2000000,1152411,0,1152411
"Sep 7, 2007",2007,In the Shadow of the Moon,2000000,1134358,1041229,2175587
"Apr 8, 2011",2011,Meek's Cutoff,2000000,977772,892156,1869928
"Nov 28, 2014",2014,The Babadook,2000000,950792,6531595,7482387
"Feb 11, 2005",2005,Inside Deep Throat,2000000,691880,0,691880
"Sep 28, 2001",2001,Dinner Rush,2000000,638227,437277,1075504
"Sep 24, 2010",2010,The Virginity Hit,2000000,636706,0,636706
"May 15, 1998",1998,Clockwatchers,2000000,537948,2013,539961
"Nov 6, 1985",1985,Subway,2000000,390659,1272637,1663296
"Apr 15, 2005",2005,House of D,2000000,388532,77574,466106
"Jan 18, 2008",2008,Teeth,2000000,347578,2003063,2350641
"Jul 26, 1996",1996,Stonewall,2000000,304602,0,304602
"Sep 8, 2006",2006,Sherrybaby,2000000,199176,560328,759504
"Feb 13, 2015",2015,The Last Five Years,2000000,147299,57999,205298
"Sep 18, 1998",1998,Six-String Samurai,2000000,134624,0,134624
"May 26, 2000",2000,Hum to Mohabbt Karega,2000000,121807,0,121807
"Apr 15, 2005",2005,It's All Gone Pete Tong,2000000,120620,2105983,2226603
"Jan 29, 2010",2010,Saint John of Las Vegas,2000000,102645,0,102645
"Apr 15, 1998",1998,24 7: Twenty Four Seven,2000000,72544,0,72544
"Sep 19, 2014",2014,Pump,2000000,72277,0,72277
"Oct 24, 2008",2008,Roadside Romeo,2000000,55202,1990888,2046090
"May 4, 2001",2001,Eureka,2000000,49388,27266,76654
"Apr 7, 2015",2015,Lost River,2000000,45431,1964213,2009644
"Jul 18, 2003",2003,This Thing of Ours,2000000,37227,0,37227
"Oct 9, 2015",2015,Knock Knock,2000000,36336,6292180,6328516
"Feb 3, 2017",2017,Growing up Smith,2000000,35312,0,35312
"Mar 20, 2009",2009,Super Capers,2000000,30955,0,30955
"Jan 1, 1993",1993,Return of the Living Dead 3,2000000,21000,0,21000
"Nov 20, 2009",2009,The Missing Person,2000000,17896,0,17896
"Oct 19, 2012",2012,The First Time,2000000,17061,0,17061
"Feb 10, 2006",2006,London,2000000,12667,0,12667
"Aug 27, 2010",2010,Circle,2000000,10024,0,10024
"Oct 31, 2008",2008,Eden Lake,2000000,7321,4287052,4294373
"Jun 11, 2010",2010,Jerusalema,2000000,7294,3385,10679
"Jun 23, 2006",2006,Say Uncle,2000000,5361,0,5361
"Sep 13, 2013",2013,Plush,2000000,3080,25784,28864
"Oct 26, 2012",2012,The Ghastly Love of Johnny X,2000000,2436,0,2436
"Dec 29, 2009",2009,Lesbian Vampire Killers,2000000,0,3620902,3620902
"Sep 9, 2011",2011,Grave Encounters,2000000,0,2151887,2151887
"Oct 23, 2015",2015,Bone Tomahawk,2000000,0,475846,475846
"Dec 10, 2004",2004,Freeze Frame,2000000,0,105377,105377
"Apr 1, 2013",2013,Stitches,2000000,0,63555,63555
"Dec 31, 2015",2015,"To Be Frank, Sinatra at 100",2000000,0,926,926
"Apr 28, 1971",1971,Bananas,2000000,0,0,0
"Dec 31, 2009",2009,Nine Dead,2000000,0,0,0
"Oct 14, 2008",2008,No Man's Land: The Rise of Reeker,2000000,0,0,0
"Jul 7, 2007",2007,Rockaway,2000000,0,0,0
"Aug 12, 1927",1927,Wings,2000000,0,0,0
"Mar 17, 2015",2015,The Lady from Shanghai,2000000,0,0,0
"Mar 19, 2013",2013,Straight A's,2000000,0,0,0
"Mar 30, 2012",2012,The Legend of Hellâs Gate: An American Conspiracy,2000000,0,0,0
"Dec 31, 2012",2012,Highway,2000000,0,0,0
"Feb 8, 2013",2013,Small Apartments,2000000,0,0,0
"Jul 9, 2013",2013,Coffee Town,2000000,0,0,0
"Dec 31, 2014",2014,Lucky Dog,2000000,0,0,0
"Dec 31, 2001",2001,Pendulum,2000000,0,0,0
"Oct 16, 1966",1966,A Funny Thing Happened on the Way to the Forum,2000000,0,0,0
"Sep 23, 2008",2008,Slacker Uprising,2000000,0,0,0
"Mar 20, 2015",2015,The Walking Deceased,2000000,0,0,0
"Dec 31, 2011",2011,True Bromance,2000000,0,0,0
"Aug 21, 2015",2015,The Curse of Downers Grove,2000000,0,0,0
"Dec 31, 2015",2015,Wind Walkers,2000000,0,0,0
"Jul 8, 2016",2016,The Dog Lover,2000000,0,0,0
"Dec 1, 2015",2015,Shark Lake,2000000,0,0,0
"Sep 24, 2010",2010,Buried,1987650,1044143,20226147,21270290
"Apr 21, 2015",2015,The Marine 4,1950000,0,0,0
"May 8, 1987",1987,River's Edge,1900000,4600000,0,4600000
"Jul 25, 2008",2008,Man on Wire,1900000,2962242,2654825,5617067
"Oct 8, 2010",2010,Nowhere Boy,1900000,1445366,6339863,7785229
"Jul 11, 2003",2003,Northfork,1900000,1420578,24562,1445140
"Apr 24, 2015",2015,Brotherly Love,1900000,478595,0,478595
"Jun 3, 2011",2011,Submarine,1900000,467602,4114335,4581937
"Apr 9, 2010",2010,The Square,1900000,406216,334716,740932
"Feb 8, 2013",2013,ABCD (Any Body Can Dance),1900000,222098,9915136,10137234
"Jun 29, 2007",2007,Chacun sa nuit,1900000,18435,120882,139317
"Jul 26, 2013",2013,Stranded,1900000,0,285593,285593
"Dec 31, 2015",2015,Vaalu,1900000,0,12444,12444
"Aug 27, 2010",2010,The Last Exorcism,1800000,41034350,29131550,70165900
"Nov 16, 1976",1976,Carrie,1800000,25878153,0,25878153
"Nov 9, 1984",1984,A Nightmare on Elm Street,1800000,25504513,0,25504513
"Jun 27, 2012",2012,Beasts of the Southern Wild,1800000,12795746,10469386,23265132
"Jan 29, 1964",1964,Dr. Strangelove,1800000,9164370,66308,9230678
"Jan 1, 1973",1973,Battle for the Planet of the Apes,1800000,8800000,0,8800000
"Sep 18, 1951",1951,A Streetcar Named Desire,1800000,8000000,0,8000000
"Aug 3, 1968",1968,Hang 'em High,1800000,6800000,0,6800000
"Nov 15, 2002",2002,El crimen de padre Amaro,1800000,5719000,0,5719000
"Jun 15, 2001",2001,Songcatcher,1800000,3050934,0,3050934
"Aug 23, 2011",2011,Higher Ground,1800000,841056,1637,842693
"Apr 22, 2011",2011,POM Wonderful Presents: The Greatest Movie Ever Sold,1800000,638476,145257,783733
"Jan 7, 2005",2005,Travellers and Magicians,1800000,506793,815368,1322161
"Jan 1, 1993",1993,Ed and his Dead Mother,1800000,673,0,673
"Dec 31, 2009",2009,Deadline,1800000,0,0,0
"Mar 13, 2007",2007,Sublime,1800000,0,0,0
"Feb 3, 2012",2012,Dysfunctional Friends,1800000,0,0,0
"Dec 31, 2013",2013,Independence Daysaster,1800000,0,0,0
"Mar 11, 2014",2014,Against the Wild,1800000,0,0,0
"Oct 20, 2015",2015,Beginnerâs Guide to Sex,1800000,0,0,0
"Jun 18, 1999",1999,Lola rennt,1750000,7267324,15611870,22879194
"Feb 7, 2003",2003,May,1750000,145540,489263,634803
"Oct 8, 2010",2010,I Spit on Your Grave,1750000,93051,1185420,1278471
"Apr 23, 2019",2019,Living Dark: The Story of Ted the Caver,1750000,0,0,0
"Nov 23, 2001",2001,In the Bedroom,1700000,35930604,6207267,42137871
"Mar 19, 2008",2008,La misma luna,1700000,12590147,10681594,23271741
"Jun 30, 1972",1972,Conquest of the Planet of the Apes,1700000,9700000,0,9700000
"Feb 28, 2014",2014,The Lunchbox,1700000,4231500,8000000,12231500
"Oct 4, 2013",2013,Grace Unplugged,1700000,2507159,0,2507159
"Oct 1, 1999",1999,"Happy, Texas",1700000,2039192,852036,2891228
"Dec 18, 2015",2015,Saul fia,1700000,1777043,7919494,9696537
"Jun 17, 2005",2005,My Summer of Love,1700000,1000915,3726460,4727375
"Jun 24, 2005",2005,Yes,1700000,396035,265186,661221
"Feb 1, 2019",2019,Braid,1660000,0,80745,80745
"Aug 5, 1953",1953,From Here to Eternity,1650000,30500000,0,30500000
"Sep 1, 1938",1938,You Can't Take It With You,1644000,4000000,0,4000000
"Apr 9, 1999",1999,Foolish,1600000,6026908,0,6026908
"Jul 26, 1949",1949,She Wore a Yellow Ribbon,1600000,5400000,0,5400000
"Apr 7, 1974",1974,The Conversation,1600000,4420000,0,4420000
"Oct 15, 2010",2010,N-Secure,1600000,2595644,0,2595644
"Feb 1, 2008",2008,Sukkar banat,1600000,1060591,13193169,14253760
"Dec 31, 1989",1989,Out of the Dark,1600000,419428,0,419428
"Jan 27, 2006",2006,Bubble,1600000,145382,0,145382
"Sep 23, 2005",2005,Dil Jo Bhi Kahey...,1600000,129319,0,129319
"Jan 15, 1999",1999,Mississippi Mermaid,1600000,27795,2600000,2627795
"Sep 26, 2014",2014,Two Night Stand,1600000,15600,852481,868081
"Nov 4, 2005",2005,I Love Your Work,1600000,3264,0,3264
"Aug 5, 1955",1955,The Kingâs Thief,1577000,0,0,0
"Apr 1, 2011",2011,Insidious,1500000,54009150,45861736,99870886
"Oct 21, 2016",2016,Moonlight,1500000,27854931,37390581,65245512
"Sep 12, 2003",2003,Cabin Fever,1500000,21158188,9193476,30351664
"May 2, 2007",2007,Waitress,1500000,19097550,3119633,22217183
"Sep 8, 1989",1989,Kickboxer,1500000,14533681,0,14533681
"Feb 26, 1988",1988,Bloodsport,1500000,11806119,0,11806119
"Oct 17, 1939",1939,Mr. Smith Goes To Washington,1500000,9000000,0,9000000
"Mar 23, 2018",2018,Unsane,1500000,7690044,6554887,14244931
"Jul 21, 1995",1995,Kids,1500000,7412216,13000000,20412216
"Oct 5, 2005",2005,The Squid and the Whale,1500000,7372734,3818689,11191423
"Mar 13, 2002",2002,Kissing Jessica Stein,1500000,7025722,2319339,9345061
"Oct 31, 1945",1945,Spellbound,1500000,7000000,0,7000000
"Apr 20, 1979",1979,Dawn of the Dead,1500000,5100000,49900000,55000000
"Sep 23, 1994",1994,Exotica,1500000,5046118,0,5046118
"Jul 26, 2013",2013,The To Do List,1500000,3491669,637159,4128828
"Feb 1, 2013",2013,The Gatekeepers,1500000,2408553,183755,2592308
"Jun 26, 1998",1998,Buffalo '66,1500000,2380606,0,2380606
"Mar 2, 1984",1984,Repo Man,1500000,2300000,0,2300000
"Oct 21, 2016",2016,Iâm Not Ashamed,1500000,2082980,0,2082980
"Jan 18, 1985",1985,Blood Simple,1500000,1690913,1039964,2730877
"Apr 19, 2002",2002,Nueve Reinas,1500000,1222889,11190000,12412889
"Apr 19, 2013",2013,The Lords of Salem,1500000,1165881,375250,1541131
"Oct 21, 2016",2016,31,1500000,779820,142907,922727
"Mar 25, 2005",2005,The Ballad of Jack and Rose,1500000,712294,413964,1126258
"Apr 22, 2016",2016,Unsullied,1500000,510957,0,510957
"Aug 31, 1994",1994,Killing Zoe,1500000,418953,0,418953
"May 17, 2002",2002,The Believer,1500000,406035,1434213,1840248
"Mar 7, 2008",2008,Snow Angels,1500000,402858,11546,414404
"Aug 10, 2001",2001,Session 9,1500000,378176,1241426,1619602
"Feb 11, 2011",2011,MOOZ-lum,1500000,362239,10000,372239
"Sep 5, 2007",2007,I Want Someone To Eat Cheese With,1500000,194568,0,194568
"Aug 19, 2011",2011,Amigo,1500000,184705,0,184705
"Sep 7, 2007",2007,Hatchet,1500000,175281,65115,240396
"Oct 31, 2008",2008,My Name is Bruce,1500000,173066,0,173066
"Aug 6, 2010",2010,The Disappearance of Alice Creed,1500000,166980,1438159,1605139
"Feb 5, 1936",1936,Modern Times,1500000,163245,36502,199747
"May 11, 2007",2007,The Salon,1500000,139084,0,139084
"Oct 25, 2013",2013,The Square,1500000,124244,52018,176262
"Mar 22, 2002",2002,Stolen Summer,1500000,119841,0,119841
"Mar 6, 2015",2015,Road Hard,1500000,113169,0,113169
"Sep 28, 2005",2005,Forty Shades of Blue,1500000,75828,96741,172569
"Oct 9, 2009",2009,Trucker,1500000,52429,0,52429
"May 29, 2009",2009,Pontypool,1500000,3865,28051,31916
"Sep 28, 2015",2015,"Me, You and Five Bucks",1500000,2105,0,2105
"Oct 17, 2014",2014,Housebound,1500000,0,236863,236863
"Jul 20, 2018",2018,Teefa in Trouble,1500000,0,98806,98806
"Nov 4, 2005",2005,Wal-Mart: The High Cost of Low Price,1500000,0,58692,58692
"Apr 17, 2014",2014,Closer to the Moon,1500000,0,5396,5396
"Mar 17, 2006",2006,Fetching Cody,1500000,0,0,0
"Jun 3, 2011",2011,The Lion of Judah,1500000,0,0,0
"Nov 11, 2014",2014,Once Upon a Time in Queens,1500000,0,0,0
"Feb 13, 2015",2015,Girlhouse,1500000,0,0,0
"May 26, 2015",2015,Mutant World,1500000,0,0,0
"Nov 20, 2015",2015,#Horror,1500000,0,0,0
"Sep 8, 2015",2015,Checkmate,1500000,0,0,0
"Dec 21, 1937",1937,Snow White and the Seven Dwarfs,1488000,184925486,0,184925486
"Jan 1, 1968",1968,Shalako,1455000,2620000,0,2620000
"Nov 30, 2018",2018,Werk ohne Autor,1400000,1303747,3027405,4331152
"Nov 20, 2015",2015,Mustang,1400000,845464,4707120,5552584
"Apr 29, 2005",2005,The Holy Girl,1400000,304124,957668,1261792
"Oct 3, 2014",2014,La chambre bleue,1400000,260441,1684979,1945420
"Sep 17, 2004",2004,Incident at Loch Ness,1400000,36830,19243,56073
"Apr 5, 2013",2013,Eddie: The Sleepwalking Cannibal,1400000,1632,0,1632
"May 1, 2010",2010,My Girlfriend's Boyfriend,1400000,0,0,0
"Dec 31, 2014",2014,Kurmanjan datka,1400000,0,0,0
"Dec 31, 2014",2014,House at the End of the Drive,1400000,0,0,0
"Jul 6, 1966",1966,Batman - The Movie,1377800,0,0,0
"Mar 5, 1999",1999,"Lock, Stock and Two Smoking Barrels",1350000,3897569,24458619,28356188
"Aug 19, 1983",1983,The Ballad of Gregorio Cortez,1305000,909000,0,909000
"Jun 26, 1936",1936,San Francisco,1300000,2868000,2405000,5273000
"Oct 9, 1998",1998,Festen,1300000,1647780,0,1647780
"Oct 11, 1996",1996,Trees Lounge,1300000,749741,0,749741
"May 22, 2009",2009,The Girlfriend Experience,1300000,695840,310000,1005840
"Mar 23, 2007",2007,Journey from the Fall,1300000,635305,0,635305
"May 5, 2000",2000,The Basket,1300000,609042,0,609042
"Jan 30, 2015",2015,Above and Beyond,1300000,288751,0,288751
"Mar 15, 1985",1985,Def-Con 4,1300000,210904,0,210904
"Dec 9, 2005",2005,Neal n' Nikki,1300000,100358,229263,329621
"Dec 19, 2003",2003,The Hebrew Hammer,1300000,77755,12458,90213
"Jun 13, 2014",2014,Los insolitos peces gato,1300000,11278,43387,54665
"Apr 7, 2006",2006,Simon,1300000,4055,1734608,1738663
"May 24, 2011",2011,Forget Me Not,1300000,0,13465,13465
"Jun 8, 2010",2010,The 41-Year-Old Virgin Who Knocked Up Sarah Marshall and Felt Superbad About It,1300000,0,0,0
"Jun 26, 2015",2015,The Algerian,1300000,0,0,0
"Mar 21, 1940",1940,Rebecca,1288000,6000000,2370,6002370
"Apr 30, 1981",1981,Friday the 13th Part 2,1250000,21722776,0,21722776
"Nov 29, 1945",1945,The Lost Weekend,1250000,11000000,0,11000000
"Aug 31, 1984",1984,C.H.U.D.,1250000,4700000,0,4700000
"Oct 17, 2014",2014,Dear White People,1250000,4404154,999617,5403771
"Apr 19, 2013",2013,Filly Brown,1250000,2850357,90054,2940411
"Jan 21, 1953",1953,Niagara,1250000,2500000,0,2500000
"Dec 31, 2016",2016,Bodom,1250000,0,726460,726460
"Oct 28, 1941",1941,How Green Was My Valley,1250000,0,0,0
"Jan 13, 2015",2015,Da Sweet Blood of Jesus,1250000,0,0,0
"Oct 29, 2004",2004,Saw,1200000,55968727,47911300,103880027
"Aug 4, 1989",1989,"Sex, Lies, and Videotape",1200000,24741667,12000000,36741667
"Feb 15, 2002",2002,Super Troopers,1200000,18492362,4553780,23046142
"Feb 22, 2002",2002,Monsoon Wedding,1200000,13876974,13148626,27025600
"Nov 10, 2000",2000,You Can Count on Me,1200000,9180275,1647081,10827356
"Jul 3, 1951",1951,Strangers on a Train,1200000,7000000,0,7000000
"Oct 3, 1955",1955,The Trouble with Harry,1200000,7000000,0,7000000
"Dec 29, 1967",1967,"Il buono, il brutto, il cattivo",1200000,6100000,0,6100000
"Sep 18, 1951",1951,The Day the Earth Stood Still,1200000,3700000,0,3700000
"Apr 19, 2013",2013,Home Run,1200000,2859955,0,2859955
"Oct 23, 1992",1992,Reservoir Dogs,1200000,2832029,0,2832029
"Jul 7, 2000",2000,But I'm a Cheerleader,1200000,2205627,303717,2509344
"Dec 23, 1956",1956,The Wrong Man,1200000,2000000,0,2000000
"Sep 26, 1975",1975,The Rocky Horror Picture Show,1200000,1414845,201131,1615976
"Jan 1, 1976",1976,The Blue Bird,1200000,887000,0,887000
"Apr 13, 2012",2012,Blue Like Jazz,1200000,595018,0,595018
"Aug 28, 2015",2015,Que Horas Ela Volta?,1200000,376976,2872065,3249041
"Nov 19, 1982",1982,Q,1200000,255000,0,255000
"Mar 21, 2003",2003,Down & Out with the Dolls,1200000,58936,0,58936
"Jun 1, 2012",2012,"Pink Ribbons, Inc.",1200000,26608,0,26608
"Feb 6, 2018",2018,Blood Feast,1200000,8708,0,8708
"Feb 11, 2011",2011,Certifiably Jonathan,1200000,7826,0,7826
"Sep 18, 2015",2015,La navaja de Don Juan,1200000,4254,0,4254
"Dec 31, 2008",2008,Extreme Movie,1200000,0,81338,81338
"Oct 20, 1936",1936,The Charge of the Light Brigade,1200000,0,0,0
"Jun 18, 2004",2004,Grand Theft Parsons,1200000,0,0,0
"Aug 28, 2012",2012,Below Zero,1200000,0,0,0
"Sep 7, 2012",2012,Crowsnest,1200000,0,0,0
"Sep 14, 2012",2012,Airborne,1200000,0,0,0
"Sep 9, 2014",2014,Cotton Comes to Harlem,1200000,0,0,0
"Feb 3, 2015",2015,Bleeding Hearts,1200000,0,0,0
"Dec 31, 2013",2013,The Wicked Within,1200000,0,0,0
"Dec 31, 2017",2017,The Islands,1200000,0,0,0
"Mar 21, 2014",2014,Godâs Not Dead,1150000,60755732,3021360,63777092
"Oct 7, 2005",2005,Waiting...,1125000,16124543,2548731,18673274
"May 12, 2006",2006,Dead Man's Shoes,1125000,6408,408328,414736
"Feb 1, 1980",1980,The Fog,1100000,21445318,502,21445820
"Dec 25, 2005",2005,Wolf Creek,1100000,16186348,12818716,29005064
"Feb 11, 2005",2005,Ong-Bak,1100000,4563167,19499798,24062965
"Mar 23, 2012",2012,Serbuan maut,1100000,4105123,5192284,9297407
"Sep 26, 1986",1986,Down by Law,1100000,1436000,0,1436000
"Sep 4, 1987",1987,The Offspring,1100000,1355728,0,1355728
"Feb 22, 2002",2002,Sex with Strangers,1100000,247740,0,247740
"May 18, 2012",2012,Beyond the Black Rainbow,1100000,56491,0,56491
"May 14, 2003",2003,Dracula: Pages from a Virgin's Diary,1100000,39659,41712,81371
"Nov 21, 2014",2014,The Sleepwalker,1100000,2636,0,2636
"Mar 7, 2017",2017,Departure,1100000,0,27561,27561
"Apr 7, 2009",2009,Faith Like Potatoes,1100000,0,0,0
"Mar 23, 2010",2010,Lake Mungo,1100000,0,0,0
"Apr 7, 2015",2015,Silent Running,1100000,0,0,0
"Dec 31, 2010",2010,The Dead Undead,1100000,0,0,0
"Dec 31, 2013",2013,The Vatican Exorcisms,1100000,0,0,0
"Dec 11, 2009",2009,Rocket Singh: Salesman of the Year,1070000,164649,5184118,5348767
"Jan 23, 1943",1943,Casablanca,1039000,10462500,34355,10496855
"Nov 21, 1976",1976,Rocky,1000000,117235147,107764853,225000000
"Jan 6, 2012",2012,The Devil Inside,1000000,53262945,48496545,101759490
"Oct 7, 1963",1963,Tom Jones,1000000,37600000,0,37600000
"Apr 17, 2015",2015,Unfriended,1000000,32789645,31574553,64364198
"Feb 8, 1976",1976,Taxi Driver,1000000,28262574,53637,28316211
"May 24, 2006",2006,An Inconvenient Truth,1000000,24146161,29219764,53365925
"Aug 23, 2013",2013,You're Next,1000000,18494006,8393171,26887177
"May 25, 2012",2012,Chernobyl Diaries,1000000,18119640,24292081,42411721
"Apr 10, 1981",1981,The Howling,1000000,17985000,0,17985000
"May 8, 1963",1963,Dr. No,1000000,16067035,43500000,59567035
"Sep 18, 1987",1987,Hellraiser,1000000,14564000,11148,14575148
"Mar 11, 2016",2016,"Hello, My Name is Doris",1000000,14444999,217704,14662703
"Sep 16, 2005",2005,Cry Wolf,1000000,10047674,5895407,15943081
"Aug 18, 2000",2000,Godzilla 2000,1000000,10037390,0,10037390
"Dec 29, 2010",2010,Blue Valentine,1000000,9737892,6828348,16566240
"Jan 20, 2006",2006,Transamerica,1000000,9015303,7537860,16553163
"Jan 1, 1970",1970,Beyond the Valley of the Dolls,1000000,9000000,0,9000000
"Nov 15, 1956",1956,Love Me Tender,1000000,9000000,0,9000000
"Jul 20, 2018",2018,Unfriended: Dark Web,1000000,8866745,7567843,16434588
"Dec 14, 1949",1949,Sands of Iwo Jima,1000000,7800000,0,7800000
"Sep 25, 2015",2015,The Green Inferno,1000000,7192291,5739129,12931420
"Feb 3, 2017",2017,I Am Not Your Negro,1000000,7123919,2493483,9617402
"Oct 19, 2012",2012,The Sessions,1000000,6002451,5492753,11495204
"Apr 4, 2008",2008,Shine a Light,1000000,5505267,10668612,16173879
"Mar 23, 2012",2012,October Baby,1000000,5355847,36145,5391992
"Sep 12, 2014",2014,The Skeleton Twins,1000000,5284309,512883,5797192
"Jun 14, 2013",2013,20 Feet From Stardom,1000000,4946250,946216,5892466
"Jun 12, 2009",2009,"Food, Inc.",1000000,4417674,314270,4731944
"Jul 28, 2017",2017,An Inconvenient Sequel,1000000,3496795,2342527,5839322
"Aug 21, 1998",1998,Next Stop Wonderland,1000000,3395581,70122,3465703
"Jun 6, 2014",2014,Obvious Child,1000000,3122616,201454,3324070
"Oct 21, 2011",2011,Martha Marcy May Marlene,1000000,2981038,2457873,5438911
"Aug 3, 2005",2005,Junebug,1000000,2678010,875243,3553253
"Aug 1, 2008",2008,Frozen River,1000000,2511476,3518653,6030129
"Nov 21, 2001",2001,Sidewalks of New York,1000000,2402459,1172849,3575308
"Apr 24, 1998",1998,Two Girls and a Guy,1000000,2057193,257833,2315026
"Sep 29, 2000",2000,The Broken Hearts Club: A Romantic Comedy,1000000,1744858,277584,2022442
"Jun 28, 2006",2006,Who Killed the Electric Car?,1000000,1678874,170518,1849392
"Sep 18, 2009",2009,The Secrets of Jonathan Sperry,1000000,1355079,0,1355079
"Jul 17, 1996",1996,Walking and Talking,1000000,1287480,328307,1615787
"Sep 19, 2003",2003,Bubba Ho-Tep,1000000,1239183,253712,1492895
"Dec 7, 2001",2001,No Man's Land,1000000,1067481,1616726,2684207
"Oct 9, 1998",1998,Slam,1000000,1009819,77702,1087521
"Oct 6, 2017",2017,Visages villages,1000000,952432,3063254,4015686
"Apr 6, 2001",2001,Brigham City,1000000,852206,0,852206
"Aug 18, 2017",2017,Patti Cake$,1000000,800148,670942,1471090
"Dec 1, 2000",2000,Panic,1000000,779137,646570,1425707
"May 9, 2014",2014,Palo Alto,1000000,767732,388577,1156309
"Sep 8, 2000",2000,Fiza,1000000,623791,555671,1179462
"Feb 3, 2010",2010,Ajami,1000000,621859,2099237,2721096
"Oct 23, 1998",1998,Orgazmo,1000000,582024,45263,627287
"Jul 29, 2011",2011,The Future,1000000,568662,670512,1239174
"Feb 14, 2003",2003,All the Real Girls,1000000,549666,153354,703020
"Oct 24, 2014",2014,23 Blast,1000000,549185,0,549185
"Jun 20, 1997",1997,Dream With The Fishes,1000000,542909,0,542909
"Jul 19, 2013",2013,The Act of Killing,1000000,486919,740397,1227316
"May 2, 2003",2003,Blue Car,1000000,464126,11241,475367
"Oct 19, 2007",2007,Wristcutters: A Love Story,1000000,446165,27604,473769
"May 5, 2000",2000,Luminarias,1000000,428535,0,428535
"Jul 18, 2014",2014,I Origins,1000000,336472,515927,852399
"Nov 28, 2014",2014,Antarctica: A Year on Ice,1000000,288757,0,288757
"Aug 22, 2003",2003,The Battle of Shaker Heights,1000000,280351,558794,839145
"Jan 18, 2008",2008,Taxi to the Dark Side,1000000,274661,29811,304472
"Apr 8, 2016",2016,The Invitation,1000000,231738,123098,354836
"Sep 24, 2004",2004,Guiana 1838,1000000,227241,0,227241
"Dec 30, 2002",2002,Love Liza,1000000,213137,0,213137
"Jul 7, 2006",2006,Once in a Lifetime: the Extraordinary Story of the New York Cosmos,1000000,144601,70958,215559
"Aug 22, 2001",2001,Lisa Picard is Famous,1000000,113433,0,113433
"Jul 31, 2015",2015,Beyond the Brick: A LEGO Brickumentary,1000000,101531,0,101531
"Oct 30, 2009",2009,The House of the Devil,1000000,101215,1597,102812
"Jun 1, 2012",2012,Hardflip,1000000,96734,0,96734
"Mar 11, 2016",2016,Creative Control,1000000,63014,0,63014
"Sep 16, 2005",2005,Chocolate: Deep Dark Secrets,1000000,49000,1500000,1549000
"Jul 1, 2011",2011,The Perfect Host,1000000,48764,2823,51587
"Sep 25, 1998",1998,The Last Big Thing,1000000,22434,0,22434
"Aug 7, 1998",1998,Safe Men,1000000,21210,0,21210
"Aug 31, 2001",2001,Speedway Junky,1000000,17127,0,17127
"Feb 13, 2015",2015,Hits,1000000,15156,0,15156
"Sep 22, 2000",2000,The Specials,1000000,12996,0,12996
"Sep 3, 2010",2010,16 to Life,1000000,11574,0,11574
"Jan 17, 2007",2007,Alone with Her,1000000,10787,833590,844377
"Oct 17, 2014",2014,Camp X-Ray,1000000,9837,91216,101053
"Nov 21, 2008",2008,Special,1000000,7202,19620,26822
"Apr 10, 2015",2015,The Sisterhood of Night,1000000,6870,0,6870
"Mar 19, 1999",1999,Sparkler,1000000,5494,0,5494
"Mar 18, 2005",2005,The Helixâ¦Loaded,1000000,3700,0,3700
"May 15, 2015",2015,Childless,1000000,1036,0,1036
"Apr 21, 2006",2006,In Her Line of Fire,1000000,884,0,884
"Dec 13, 2002",2002,The Jimmy Show,1000000,703,0,703
"Dec 31, 2013",2013,Heli,1000000,0,552614,552614
"Dec 31, 2015",2015,Karachi se Lahore,1000000,0,17721,17721
"Dec 31, 2006",2006,Loving Annabelle,1000000,0,5382,5382
"Dec 11, 2015",2015,American Hero,1000000,0,26,26
"Dec 1, 2009",2009,Frat Party,1000000,0,0,0
"Sep 15, 2006",2006,Jimmy and Judy,1000000,0,0,0
"Oct 24, 2003",2003,The Party's Over,1000000,0,0,0
"Jul 17, 2009",2009,The Poker House,1000000,0,0,0
"Sep 23, 2005",2005,Proud,1000000,0,0,0
"Dec 31, 2008",2008,Steppin: The Movie,1000000,0,0,0
"Jan 29, 2010",2010,Zombies of Mass Destruction,1000000,0,0,0
"Mar 20, 2012",2012,Snow White: A Deadly Summer,1000000,0,0,0
"Oct 9, 2012",2012,Truth or Die,1000000,0,0,0
"May 14, 2013",2013,Black Rock,1000000,0,0,0
"Jan 7, 2014",2014,Hidden Away,1000000,0,0,0
"Oct 4, 2013",2013,My Last Day Without You,1000000,0,0,0
"Oct 8, 2013",2013,Zombie Hunter,1000000,0,0,0
"Dec 31, 2014",2014,Doc Holliday's Revenge,1000000,0,0,0
"Jun 24, 2014",2014,A Fine Step,1000000,0,0,0
"Feb 10, 2015",2015,Fear Clinic,1000000,0,0,0
"Mar 10, 2015",2015,The Pet,1000000,0,0,0
"Dec 31, 2014",2014,Bang Bang Baby,1000000,0,0,0
"Apr 8, 2016",2016,Hush,1000000,0,0,0
"Mar 1, 2016",2016,1982,1000000,0,0,0
"Oct 27, 2015",2015,The Horror Network,1000000,0,0,0
"Dec 31, 2016",2016,Chemical Cut,1000000,0,0,0
"Dec 22, 2015",2015,Por amor en el caserio,1000000,0,0,0
"Jun 1, 2007",2007,And Then Came Love,989000,8158,0,8158
"Apr 14, 2006",2006,Hard Candy,950000,1024640,7242426,8267066
"Sep 27, 2002",2002,Charly,950000,814666,0,814666
"Jan 10, 2014",2014,Banshee Chapter,950000,0,78122,78122
"Dec 31, 2012",2012,Trance,950000,0,0,0
"Aug 12, 2014",2014,Jesse,950000,0,0,0
"Mar 3, 2015",2015,Ask Me Anything,950000,0,0,0
"Apr 13, 2012",2012,L!fe Happens,930000,30905,0,30905
"May 12, 2017",2017,Lowriders,916000,6179955,8466,6188421
"Nov 21, 2014",2014,Food Chains,913000,0,176,176
"Jul 28, 1954",1954,On the Waterfront,910000,9600000,0,9600000
"Jul 12, 2013",2013,Fruitvale Station,900000,16098998,1450647,17549645
"Apr 1, 2016",2016,Meet the Blacks,900000,9097072,0,9097072
"Jan 25, 2008",2008,"4 luni, 3 saptamani si 2 zile",900000,1196321,10796835,11993156
"Aug 26, 2011",2011,Circumstance,900000,454121,504857,958978
"Aug 25, 2006",2006,The Quiet,900000,381420,0,381420
"Apr 27, 2012",2012,The Giant Mechanical Man,900000,7396,0,7396
"Apr 5, 2013",2013,The Brass Teapot,900000,6997,406736,413733
"Dec 31, 2014",2014,40 Weeks,900000,0,0,0
"May 5, 2015",2015,Le bonheur d'Elza,900000,0,0,0
"Aug 13, 1942",1942,Bambi,858000,102797000,165203000,268000000
"Aug 31, 2012",2012,"For a Good Time, Call",850000,1251749,134339,1386088
"Jan 30, 2004",2004,Latter Days,850000,833118,32590,865708
"Mar 21, 2008",2008,The Hammer,850000,442638,0,442638
"Aug 28, 2015",2015,Windsor Drive,850000,3256,0,3256
"Dec 31, 2012",2012,Snitch,850000,0,0,0
"Dec 31, 2008",2008,Harrison Montgomery,850000,0,0,0
"Aug 3, 2012",2012,Celeste and Jesse Forever,840000,3103407,684282,3787689
"Oct 25, 2002",2002,Time Changer,825000,1500711,0,1500711
"Aug 11, 2009",2009,London to Brighton,825000,0,610776,610776
"Dec 31, 2009",2009,Crying With Laughter,820000,0,16909,16909
"Jan 1, 1971",1971,Billy Jack,800000,98000000,0,98000000
"Dec 30, 2011",2011,Jodaeiye Nader az Simin,800000,7098492,17327677,24426169
"May 10, 1996",1996,Welcome to the Dollhouse,800000,4198137,836657,5034794
"Mar 28, 2003",2003,Raising Victor Vargas,800000,2073984,826594,2900578
"Oct 1, 1993",1993,Ruby in Paradise,800000,1001437,0,1001437
"Aug 9, 2002",2002,Pandora's Box,800000,881950,0,881950
"Jul 18, 2007",2007,Cama adentro,800000,200433,0,200433
"Mar 10, 2000",2000,Deterrence,800000,144583,227064,371647
"May 7, 2004",2004,The Mudge Boy,800000,62544,0,62544
"Apr 11, 2003",2003,The Young Unknowns,800000,58163,0,58163
"Jun 19, 2009",2009,DÃ¸d snÃ¸,800000,46742,2147278,2194020
"Sep 19, 2014",2014,Not Cool,800000,35688,0,35688
"Feb 3, 2012",2012,Kill List,800000,29063,433143,462206
"Jan 9, 2015",2015,Vessel,800000,0,0,0
"Aug 6, 2004",2004,Saints and Soldiers,780000,1310470,0,1310470
"Aug 11, 1973",1973,American Graffiti,777000,115000000,25000000,140000000
"Sep 8, 2006",2006,Iraq for Sale: The War Profiteers,775000,0,0,0
"Sep 9, 2011",2011,Kevin Hart: Laugh at My Pain,750000,7706436,6000,7712436
"Apr 13, 2007",2007,Aqua Teen Hunger Force Colon Movie Film for Theaters,750000,5520368,0,5520368
"Jun 8, 2012",2012,Safety Not Guaranteed,750000,4010957,411361,4422318
"Feb 3, 2012",2012,The Innkeepers,750000,78396,933139,1011535
"Aug 29, 2014",2014,Il conformista,750000,59656,29953,89609
"Nov 15, 2002",2002,Interview with the Assassin,750000,47329,0,47329
"Jul 1, 2005",2005,Undead,750000,41196,188054,229250
"Jan 23, 2009",2009,Donkey Punch,750000,19367,795434,814801
"Oct 11, 2013",2013,All the Boys Love Mandy Lane,750000,0,1960521,1960521
"Dec 31, 2014",2014,Destiny,750000,0,450,450
"Apr 7, 2009",2009,Bled,750000,0,0,0
"Jan 5, 2016",2016,Adulterers,750000,0,0,0
"Jun 25, 1968",1968,La mariÃ©e Ã©tait en noir,747000,44566,0,44566
"Jul 24, 1952",1952,High Noon,730000,8000000,0,8000000
"Oct 14, 1994",1994,Hoop Dreams,700000,7768371,4000000,11768371
"Jun 24, 2005",2005,Rize,700000,3278611,1579120,4857731
"Aug 11, 2006",2006,Half Nelson,700000,2697938,2213787,4911725
"Sep 7, 2001",2001,L.I.E.,700000,1140965,0,1140965
"Aug 4, 2017",2017,Columbus,700000,1017107,93404,1110511
"Oct 8, 1999",1999,Naturally Native,700000,10508,0,10508
"Jan 26, 2010",2010,B-Girl,700000,0,1160,1160
"Mar 13, 2015",2015,Walter,700000,0,0,0
"Apr 7, 1933",1933,King Kong,672000,10000000,650,10000650
"Apr 10, 1953",1953,House of Wax,658000,23800000,0,23800000
"Jun 19, 1998",1998,Hav Plenty,650000,2301777,0,2301777
"Oct 11, 2013",2013,Escape from Tomorrow,650000,171962,0,171962
"Dec 14, 2018",2018,That Way Madness Lies,650000,1447,0,1447
"Dec 31, 2012",2012,After,650000,0,0,0
"Dec 31, 2014",2014,The Hadza: Last of the First,650000,0,0,0
"Dec 31, 2009",2009,Starsuckers,640000,0,14812,14812
"Dec 31, 2013",2013,Treachery,625000,0,0,0
"Sep 6, 1935",1935,Top Hat,609000,1782000,1420000,3202000
"Jul 14, 1999",1999,The Blair Witch Project,600000,140539099,107760901,248300000
"Mar 26, 1970",1970,Woodstock,600000,34505110,0,34505110
"Aug 10, 1977",1977,The Kentucky Fried Movie,600000,15000000,5000000,20000000
"May 10, 1967",1967,Per qualche dollaro in piÃ¹,600000,4300000,0,4300000
"Oct 31, 2000",2000,Mercy Streets,600000,173599,0,173599
"May 2, 2014",2014,Water & Power,600000,42557,0,42557
"Oct 19, 2007",2007,Arnolds Park,600000,23616,0,23616
"Jul 2, 1999",1999,Broken Vessels,600000,15030,70313,85343
"May 22, 2015",2015,Drunk Wedding,600000,3301,0,3301
"Mar 4, 2016",2016,They Will Have to Kill Us First,600000,0,7943,7943
"Aug 23, 2002",2002,Crop Circles: Quest for Truth,600000,0,0,0
"Aug 8, 2014",2014,The Maid's Room,600000,0,0,0
"Dec 31, 2014",2014,Light from the Darkroom,600000,0,0,0
"Feb 24, 2015",2015,Irreplaceable,600000,0,0,0
"Aug 11, 1964",1964,A Hard Day's Night,560000,1537860,88924,1626784
"Jul 29, 2011",2011,The Harvest/La Cosecha,560000,3709,0,3709
"Dec 31, 2015",2015,Julija in alfa Romeo,560000,0,8462,8462
"Dec 26, 1931",1931,Mata Hari,558000,900000,0,900000
"May 9, 1980",1980,Friday the 13th,550000,39754601,20000000,59754601
"Apr 27, 1984",1984,Love Letters,550000,5269990,0,5269990
"Sep 12, 2014",2014,Faith Connections,550000,9111,0,9111
"Mar 6, 2012",2012,High Road,546173,0,0,0
"Sep 26, 2008",2008,Fireproof,500000,33456317,16980,33473297
"Nov 15, 1974",1974,Benji,500000,31559560,0,31559560
"Aug 6, 2004",2004,Open Water,500000,30500882,25017759,55518641
"Jan 1, 1977",1977,Kingdom of the Spiders,500000,17000000,0,17000000
"May 13, 2005",2005,Mad Hot Ballroom,500000,8117961,1269620,9387581
"Oct 3, 2003",2003,The Station Agent,500000,5801558,3668651,9470209
"Jan 22, 2010",2010,To Save a Life,500000,3777210,47658,3824868
"Jun 16, 2006",2006,Wordplay,500000,3121270,56366,3177636
"Oct 22, 1999",1999,Beyond the Mat,500000,2047570,0,2047570
"Feb 1, 2002",2002,The Singles Ward,500000,1250798,0,1250798
"Jul 8, 2011",2011,Sholem Aleichem: Laughing in the Darkness,500000,1131261,0,1131261
"Jan 30, 2004",2004,Osama,500000,1127331,844148,1971479
"Jun 9, 2000",2000,Groove,500000,1115313,52211,1167524
"Jan 31, 2003",2003,The R.M.,500000,1111615,0,1111615
"Jul 30, 1999",1999,Twin Falls Idaho,500000,985341,41887,1027228
"Aug 20, 2004",2004,Mean Creek,500000,603951,744799,1348750
"Aug 23, 2013",2013,Drinking Buddies,500000,343706,63394,407100
"Feb 13, 1998",1998,Hurricane Streets,500000,334041,33541,367582
"Jul 12, 2002",2002,Never Again,500000,307631,1162,308793
"Nov 19, 1956",1956,Shichinin no samurai,500000,271736,0,271736
"Aug 29, 2003",2003,Civil Brand,500000,254293,0,254293
"Oct 29, 2010",2010,Monsters,500000,237301,5402429,5639730
"Mar 24, 2006",2006,Lonesome Jim,500000,154187,448602,602789
"Apr 17, 2013",2013,Deceptive Practice: The Mysteries and Mentors of Ricky Jay,500000,152449,0,152449
"Sep 28, 2012",2012,The Other Dream Team,500000,134109,180335,314444
"Dec 11, 2015",2015,O Menino e o Mundo,500000,129479,151488,280967
"Apr 1, 2011",2011,Rubber,500000,100370,580544,680914
"Jan 1, 1991",1991,Johnny Suede,500000,55000,0,55000
"Oct 5, 2007",2007,Finishing the Game,500000,52850,351,53201
"Apr 18, 2008",2008,Kiss the Bride,500000,32033,0,32033
"Jul 11, 2003",2003,The Journey,500000,19800,0,19800
"Apr 23, 2009",2009,Home,500000,15433,44777735,44793168
"Jan 10, 2003",2003,The Slaughter Rule,500000,13134,0,13134
"May 14, 2010",2010,The Living Wake,500000,12232,0,12232
"Feb 27, 2009",2009,Scott Walker: 30 Century Man,500000,6840,70281,77121
"Oct 21, 2005",2005,The Californians,500000,4134,0,4134
"Sep 10, 2014",2014,Born to Fly: Elizabeth Streb vs. Gravity,500000,1822,0,1822
"Jun 28, 2013",2013,Detention of the Dead,500000,1778,0,1778
"May 11, 2018",2018,Higher Power,500000,528,0,528
"Dec 31, 2006",2006,Feng kuang de shi tou,500000,0,3000000,3000000
"Jan 8, 2013",2013,Now is Good,500000,0,2141436,2141436
"Dec 31, 2006",2006,Griffin & Phoenix,500000,0,1355967,1355967
"Nov 2, 2001",2001,Everything Put Together,500000,0,7890,7890
"Dec 31, 2010",2010,Drones,500000,0,0,0
"Apr 3, 2012",2012,Enter Nowhere,500000,0,0,0
"Jul 17, 2012",2012,Girls Gone Dead,500000,0,0,0
"Dec 31, 2005",2005,Insomnia Manica,500000,0,0,0
"Dec 31, 2014",2014,America Is Still The Place,500000,0,0,0
"Jul 24, 2015",2015,The Outrageous Sophie Tucker,500000,0,0,0
"Mar 10, 2015",2015,Subconscious,500000,0,0,0
"Apr 14, 2015",2015,Roadside,500000,0,0,0
"Dec 31, 2014",2014,Diamond Ruff,500000,0,0,0
"Feb 10, 2015",2015,Love in the Time of Monsters,500000,0,0,0
"Dec 31, 2012",2012,El rey de Najayo,500000,0,0,0
"Dec 31, 2015",2015,Fight to the Finish,500000,0,0,0
"Dec 31, 2013",2013,Bucky and the Squirrels,500000,0,0,0
"Dec 31, 1990",1990,Going Under,500000,0,0,0
"Jun 23, 2015",2015,Crossroads,500000,0,0,0
"Aug 11, 2015",2015,Alleluia! The Devil's Carnival,500000,0,0,0
"Dec 1, 2015",2015,Brooklyn Bizarre,500000,0,0,0
"Dec 31, 2014",2014,The Sound and the Shadow,500000,0,0,0
"Dec 31, 2015",2015,Rodeo Girl,500000,0,0,0
"Nov 10, 2015",2015,The Little Ponderosa Zoo,500000,0,0,0
"Dec 31, 1984",1984,The Toxic Avenger,475000,0,0,0
"Sep 25, 2009",2009,Paranormal Activity,450000,107918810,86264224,194183034
"Jan 1, 1991",1991,Straight out of Brooklyn,450000,2712293,0,2712293
"Mar 31, 2006",2006,Brick,450000,2075743,2168253,4243996
"Aug 22, 1997",1997,Sunday,450000,410919,39430,450349
"Aug 11, 2006",2006,Conversations with Other Women,450000,379418,918327,1297745
"Nov 20, 2015",2015,Siakh lokhamim: ha'slilim ha'gnouzim,450000,41260,1243,42503
"May 9, 2008",2008,Poultrygeist: Night of the Chicken Dead,450000,13804,8819,22623
"Jul 11, 2014",2014,As It Is in Heaven,450000,13486,0,13486
"Jul 1, 2014",2014,Mutual Friends,450000,0,0,0
"Dec 31, 2014",2014,Rise Of the Entrepreneur - The Search For A Better Way,450000,0,0,0
"Mar 9, 1933",1933,42nd Street,439000,1438000,843000,2281000
"Aug 3, 1990",1990,Metropolitan,430000,2938000,0,2938000
"Apr 28, 2006",2006,Moartea domnului Lazarescu,425000,80301,501003,581304
"Jan 21, 2005",2005,Gory Gory Hallelujah,425000,12604,0,12604
"Apr 25, 2014",2014,Blue Ruin,420000,258384,178618,437002
"Jun 11, 2004",2004,Napoleon Dynamite,400000,44540956,1581757,46122713
"May 10, 1975",1975,Monty Python and the Holy Grail,400000,3427696,1601252,5028948
"Aug 2, 2006",2006,Quinceanera,400000,1692693,1104506,2797199
"Apr 26, 2002",2002,Dogtown and Z-Boys,400000,1293295,307271,1600566
"Oct 24, 2008",2008,Heroes,400000,655538,0,655538
"Oct 6, 2004",2004,Tarnation,400000,592014,570000,1162014
"Oct 15, 2010",2010,I Want Your Money,400000,433588,0,433588
"Jan 1, 1983",1983,E tu vivrai nel terrore - L'aldilÃ,400000,126387,0,126387
"May 16, 1980",1980,Home Movies,400000,89134,0,89134
"Jul 27, 2001",2001,Jackpot,400000,44452,0,44452
"Dec 10, 2004",2004,Fabled,400000,31425,0,31425
"Oct 13, 2005",2005,The Dark Hours,400000,423,0,423
"Mar 31, 2015",2015,Viskningar och rop,400000,0,9071,9071
"Apr 1, 1986",1986,My Beautiful Laundrette,400000,0,0,0
"Nov 4, 2005",2005,Show Me,400000,0,0,0
"Dec 31, 2014",2014,Pancakes,400000,0,0,0
"Sep 5, 1916",1916,Intolerance,385907,0,0,0
"Feb 1, 1929",1929,The Broadway Melody,379000,2800000,1558000,4358000
"Apr 15, 1983",1983,The Evil Dead,375000,2400000,27000000,29400000
"May 21, 1999",1999,Trekkies,375000,617172,0,617172
"Jan 1, 1980",1980,Maniac,350000,10000000,0,10000000
"Jan 1, 1987",1987,American Ninja 2: The Confrontation,350000,4000000,0,4000000
"Jul 8, 2005",2005,Murderball,350000,1531154,241825,1772979
"Sep 1, 2010",2010,My Dog Tulip,350000,246574,64317,310891
"Oct 18, 2006",2006,51 Birch Street,350000,84689,0,84689
"Nov 15, 2002",2002,Revolution#9,350000,9118,0,9118
"Apr 10, 2009",2009,Royal Kill,350000,0,0,0
"Oct 20, 2015",2015,Rotor DR1,350000,0,0,0
"Apr 13, 1957",1957,12 Angry Men,340000,0,0,0
"Oct 17, 1978",1978,Halloween,325000,47000000,23000000,70000000
"Feb 22, 1934",1934,It Happened One Night,325000,2500000,0,2500000
"Jun 25, 2010",2010,Kynodontas,323000,110248,1263159,1373407
"Nov 24, 1999",1999,Tumbleweeds,312000,1350248,437920,1788168
"Nov 14, 2003",2003,Tupac Resurrection,300000,7718961,89563,7808524
"Mar 10, 2000",2000,God's Army,300000,2637726,14789,2652515
"Oct 17, 2003",2003,Pieces of April,300000,2528664,1042589,3571253
"Sep 20, 1996",1996,When The Cat's Away,300000,1652472,873512,2525984
"Dec 10, 2008",2008,Wendy and Lucy,300000,865695,550351,1416046
"Sep 11, 1998",1998,Let's Talk About Sex,300000,373615,0,373615
"Aug 25, 2006",2006,Old Joy,300000,255923,143985,399908
"Jul 15, 2005",2005,First Morning,300000,87264,0,87264
"Jun 15, 2007",2007,Pierrot le fou,300000,70807,573,71380
"Mar 5, 1997",1997,The Watermelon Woman,300000,42735,0,42735
"Mar 11, 2011",2011,3 Backyards,300000,39475,0,39475
"Apr 12, 2006",2006,Sisters in Law,300000,33312,0,33312
"Nov 9, 2012",2012,Nothing But a Man,300000,17241,0,17241
"Jul 19, 2002",2002,Ayurveda: Art of Being,300000,16892,2050000,2066892
"Aug 7, 1998",1998,"First Love, Last Rites",300000,10876,0,10876
"May 6, 2005",2005,Fighting Tommy Riley,300000,10514,0,10514
"Mar 28, 2014",2014,Locker 13,300000,3496,0,3496
"Oct 23, 2015",2015,The Looking Glass,300000,1711,0,1711
"Oct 31, 2014",2014,All You Need Is Love,300000,0,3565259,3565259
"Apr 1, 1975",1975,Death Race 2000,300000,0,0,0
"Jul 3, 2012",2012,Some Guy Who Kills People,300000,0,0,0
"Aug 7, 2013",2013,Midnight Cabaret,300000,0,0,0
"Mar 10, 2015",2015,Teeth and Blood,300000,0,0,0
"Dec 31, 2015",2015,Walking to Paris,300000,0,0,0
"Dec 31, 2010",2010,Anderson's Cross,300000,0,0,0
"Dec 8, 2015",2015,Amidst the Devil's Wings,300000,0,0,0
"Dec 31, 2010",2010,Death Calls,290000,0,0,0
"Aug 17, 2012",2012,Compliance,270000,319285,511415,830700
"May 1, 1981",1981,Graduation Day,250000,23894000,0,23894000
"Apr 4, 1997",1997,Chasing Amy,250000,12006514,3148581,15155095
"Jun 28, 2002",2002,Lovely and Amazing,250000,4210379,403103,4613482
"Apr 28, 2017",2017,Sleight,250000,3930990,3460,3934450
"Apr 11, 2003",2003,Better Luck Tomorrow,250000,3802390,6836,3809226
"Oct 28, 2011",2011,Like Crazy,250000,3395391,333009,3728400
"Jun 16, 1995",1995,The Incredibly True Adventure of Two Girls in Love,250000,2210408,266747,2477155
"Jul 14, 2000",2000,Chuck&Buck,250000,1055671,102001,1157672
"Mar 16, 2001",2001,American Desi,250000,902835,463400,1366235
"Sep 11, 1998",1998,Cube,250000,489220,8479845,8969065
"Mar 28, 1997",1997,Love and Other Catastrophes,250000,212285,530931,743216
"Aug 28, 1998",1998,I Married a Strange Person,250000,203134,0,203134
"Jul 22, 2005",2005,November,250000,191862,0,191862
"Sep 17, 1999",1999,Sugar Town,250000,178095,0,178095
"Mar 28, 2008",2008,Happy Valley,250000,67665,0,67665
"Aug 2, 2013",2013,The Canyons,250000,59671,2704,62375
"Jun 28, 2006",2006,The Motel,250000,51540,0,51540
"Jul 15, 2005",2005,On the Outs,250000,49772,188044,237816
"Dec 14, 2007",2007,Shotgun Stories,250000,46026,238148,284174
"Aug 15, 2014",2014,Nightlights,250000,21147,0,21147
"Jun 6, 2014",2014,Test,250000,18823,0,18823
"Jan 8, 1999",1999,The Sticky Fingers of Time,250000,18195,2433,20628
"Mar 24, 2015",2015,Along the Roadside,250000,0,3234,3234
"Oct 21, 2008",2008,Sunday School Musical,250000,0,0,0
"Oct 5, 2010",2010,Rust,250000,0,0,0
"Dec 31, 2010",2010,The Christmas Bunny,250000,0,0,0
"Nov 10, 2009",2009,Ink,250000,0,0,0
"Dec 18, 2012",2012,The Frozen,250000,0,0,0
"Apr 11, 2014",2014,Jesus People,250000,0,0,0
"Dec 31, 2010",2010,Butterfly,250000,0,0,0
"Feb 3, 2015",2015,UnDivided,250000,0,0,0
"Dec 31, 2014",2014,Horse Camp,250000,0,0,0
"Feb 24, 2015",2015,Give Me Shelter,250000,0,0,0
"Dec 31, 2011",2011,Rock the House,250000,0,0,0
"Dec 31, 2015",2015,Shooting the Warwicks,250000,0,0,0
"Aug 18, 2015",2015,The Love Letter,250000,0,0,0
"Oct 9, 2015",2015,Western Religion,250000,0,0,0
"Jan 1, 2015",2015,4/11,250000,0,0,0
"Nov 19, 1925",1925,The Big Parade,245000,11000000,11000000,22000000
"Oct 31, 2008",2008,Little Big Top,240000,7484,0,7484
"Oct 9, 2009",2009,Bronson,230000,104979,2598783,2703762
"Jul 20, 2012",2012,Burn,225000,1109276,0,1109276
"Sep 15, 2000",2000,Urbania,225000,1032075,0,1032075
"Jun 13, 1953",1953,"The Beast from 20,000 Fathoms",210000,5000000,0,5000000
"Jul 25, 1969",1969,The Stewardesses,200000,13500000,11500000,25000000
"Mar 21, 1980",1980,Mad Max,200000,8750000,91000000,99750000
"Dec 24, 1916",1916,"20,000 Leagues Under the Sea",200000,8000000,0,8000000
"Oct 18, 1996",1996,Swingers,200000,4505922,2112656,6618578
"Jan 18, 1967",1967,Per un pugno di dollari,200000,3500000,16248,3516248
"Feb 25, 2011",2011,The Grace Card,200000,2430735,0,2430735
"Feb 9, 1933",1933,She Done Him Wrong,200000,2000000,0,2000000
"Feb 11, 2000",2000,Trois,200000,1161843,0,1161843
"Jun 19, 2015",2015,The Overnight,200000,1109808,56188,1165996
"Oct 22, 2004",2004,Short Cut to Nirvana: Kumbh Mela,200000,381225,58426,439651
"Oct 12, 2012",2012,Middle of Nowhere,200000,236806,0,236806
"Oct 10, 2008",2008,Call+Response,200000,212989,0,212989
"May 10, 2002",2002,The Business of Fancy Dancing,200000,174682,0,174682
"May 10, 2002",2002,Hybrid,200000,162605,0,162605
"Jun 13, 2008",2008,Baghead,200000,140016,0,140016
"Sep 10, 2004",2004,Malevolence,200000,126021,220085,346106
"Sep 9, 2005",2005,Side Effects,200000,44701,0,44701
"Oct 10, 2008",2008,Good Dick,200000,28835,23608,52443
"Jul 21, 2006",2006,The Case of the Grinning Cat,200000,7033,0,7033
"Jan 7, 2005",2005,Solitude,200000,6260,0,6260
"Mar 14, 2014",2014,The Word,200000,3648,0,3648
"Jun 15, 2007",2007,The Trials of Darryl Hunt,200000,1217,0,1217
"Oct 19, 2007",2007,The Man From Earth,200000,0,0,0
"Dec 31, 2004",2004,Samantha: An American Girl Holiday,200000,0,0,0
"Jan 17, 2008",2008,Yesterday Was a Lie,200000,0,0,0
"Sep 12, 2014",2014,Archaeology of a Woman,200000,0,0,0
"Aug 26, 2014",2014,Sanctuary; Quite a Conundrum,200000,0,0,0
"Sep 29, 2015",2015,Theresa Is a Mother,200000,0,0,0
"Nov 10, 2015",2015,Perfect Cowboy,200000,0,0,0
"Dec 31, 2014",2014,H.,200000,0,0,0
"Sep 23, 2011",2011,Weekend,190000,484592,1092993,1577585
"Jan 22, 1999",1999,Bacheha-Ye aseman,180000,933933,694646,1628579
"Feb 27, 2015",2015,Butterfly Girl,180000,17503,0,17503
"Jun 16, 2017",2017,Arrowhead,180000,0,0,0
"Aug 8, 1986",1986,She's Gotta Have It,175000,7137502,0,7137502
"Jul 22, 2011",2011,Another Earth,175000,1321194,781585,2102779
"Aug 23, 2013",2013,Sparrows Dance,175000,2602,0,2602
"Sep 4, 2015",2015,Heroes of Dirt,175000,0,0,0
"Jun 3, 2016",2016,The Fits,170000,166425,2817,169242
"Jun 30, 1979",1979,Dolphin,170000,14000,0,14000
"Dec 31, 2015",2015,Lumea e a mea,168000,0,29678,29678
"Sep 11, 2009",2009,The Horse Boy,160000,156612,0,156612
"Mar 1, 2002",2002,The Calling,160000,32092,0,32092
"Jan 1, 1971",1971,Sweet Sweetback's Baad Asssss Song,150000,15200000,0,15200000
"May 16, 2007",2007,Once,150000,9445857,13877774,23323631
"Jul 19, 2002",2002,Tadpole,150000,2891288,378840,3270128
"Jun 23, 2000",2000,The Woman Chaser,150000,110719,0,110719
"Apr 17, 2015",2015,Antarctic Edge: 70Âº South,150000,7193,0,7193
"Aug 21, 2015",2015,Top Spin,150000,5858,0,5858
"Dec 31, 2013",2013,Speak No Evil,150000,0,32927,32927
"Oct 6, 2009",2009,A Charlie Brown Christmas,150000,0,0,0
"May 3, 2013",2013,Aroused,150000,0,0,0
"Dec 31, 2015",2015,Escaping the Holocost,150000,0,0,0
"Oct 18, 1974",1974,The Texas Chainsaw Massacre,140000,26572439,0,26572439
"Dec 20, 1989",1989,Roger & Me,140000,6706368,0,6706368
"Apr 27, 2012",2012,Sound of My Voice,135000,408015,21433,429448
"Nov 16, 1942",1942,Cat People,134000,4000000,4000000,8000000
"Jul 18, 2014",2014,An American in Hollywood,125000,0,0,0
"Aug 11, 2015",2015,The Brain That Sings,125000,0,0,0
"Dec 31, 2015",2015,Romantic Schemer,125000,0,0,0
"Jun 15, 2012",2012,Your Sister's Sister,120000,1597486,1493107,3090593
"Jun 30, 2006",2006,The Blood of My Brother: A Story of Death in Iraq,120000,0,0,0
"Dec 31, 2007",2007,A Dog's Breakfast,120000,0,0,0
"May 24, 2016",2016,Une Femme MariÃ©e,120000,0,0,0
"Oct 1, 1968",1968,Night of the Living Dead,114000,12087064,18000000,30087064
"Feb 8, 1915",1915,The Birth of a Nation,110000,10000000,1000000,11000000
"Oct 3, 2003",2003,The Work and the Story,103000,16137,0,16137
"Jul 10, 2015",2015,The Gallows,100000,22764410,18892064,41656474
"Sep 29, 2006",2006,Facing the Giants,100000,10178331,64828,10243159
"Jan 1, 1977",1977,Eraserhead,100000,7000000,14590,7014590
"Mar 1, 1987",1987,Hollywood Shuffle,100000,5228617,0,5228617
"Sep 17, 1920",1920,Over the Hill to the Poorhouse,100000,3000000,0,3000000
"Oct 9, 1998",1998,The Mighty,100000,2652246,3469336,6121582
"Jul 7, 2017",2017,A Ghost Story,100000,1594798,1174984,2769782
"May 10, 1980",1980,Penitentiary,100000,287000,0,287000
"Feb 6, 2004",2004,The Lost Skeleton of Cadavra,100000,110536,0,110536
"Mar 21, 2014",2014,Cheap Thrills,100000,59424,0,59424
"Jun 19, 2014",2014,The Past is a Grotesque Animal,100000,20056,0,20056
"Nov 9, 2001",2001,Keeping it Real: The Adventures of Greg Walloch,100000,1358,0,1358
"May 18, 2012",2012,Indie Game: The Movie,100000,0,0,0
"Dec 31, 2014",2014,"Dude, Where's My Dog",100000,0,0,0
"Jun 10, 2014",2014,Echo Dr.,100000,0,0,0
"Mar 17, 2015",2015,Closure,100000,0,0,0
"Dec 31, 2015",2015,Lunchtime Heroes,100000,0,0,0
"Mar 25, 2015",2015,Open Secret,100000,0,0,0
"Nov 10, 2015",2015,The Night Visitor,100000,0,0,0
"Jul 7, 2015",2015,Tiger Orange,100000,0,0,0
"Aug 30, 1972",1972,The Last House on the Left,87000,3100000,0,3100000
"May 30, 2008",2008,The Foot Fist Way,79000,234286,0,234286
"Jul 17, 2015",2015,Dawn of the Crescent Moon,75000,8799,0,8799
"Sep 29, 2015",2015,Queen Crab,75000,0,0,0
"Jul 25, 2014",2014,Happy Christmas,70000,30312,0,30312
"Jan 28, 2005",2005,"Peace, Propaganda and the Promised Land",70000,4930,0,4930
"Dec 31, 2011",2011,Absentia,70000,0,8555,8555
"Jul 10, 1998",1998,Pi,68000,3221152,1457361,4678513
"Feb 20, 1998",1998,I Love You â¦ Don't Touch Me!,68000,33598,0,33598
"Feb 26, 1999",1999,20 Dates,66000,541636,61284,602920
"May 7, 2004",2004,Super Size Me,65000,11529368,10704440,22233808
"Jan 25, 2013",2013,Supporting Characters,60000,4917,0,4917
"Mar 16, 2012",2012,The FP,60000,0,0,0
"Dec 31, 2012",2012,Hayride,60000,0,0,0
"Aug 10, 1962",1962,The Brain That Wouldn't Die,60000,0,0,0
"Oct 4, 2013",2013,The Dirties,55000,0,0,0
"Aug 9, 1995",1995,The Brothers McMullen,50000,10426506,0,10426506
"Mar 16, 2001",2001,Gabriela,50000,2335352,0,2335352
"Nov 12, 2010",2010,Tiny Furniture,50000,391674,32475,424149
"Feb 22, 2008",2008,The Signal,50000,251150,155149,406299
"Jul 31, 2015",2015,Counting,50000,8374,0,8374
"Dec 31, 2009",2009,Big Things,50000,0,0,0
"Feb 14, 2014",2014,Down and Dangerous,50000,0,0,0
"Dec 31, 2005",2005,The Call of Cthulhu,50000,0,0,0
"Aug 4, 2015",2015,Bending Steel,50000,0,0,0
"Sep 1, 2015",2015,"Run, Hide, Die",50000,0,0,0
"Dec 31, 2014",2014,The Image Revolution,50000,0,0,0
"Oct 25, 2013",2013,A True Story,45000,0,0,0
"Oct 27, 2000",2000,George Washington,42000,241816,100906,342722
"Jun 21, 2013",2013,This Is Martin Bonner,42000,0,0,0
"Aug 25, 2000",2000,Smiling Fish and Goat on Fire,40000,277233,0,277233
"Mar 12, 2010",2010,The Exploding Girl,40000,25572,0,25572
"Feb 11, 2011",2011,Raymond Did It,40000,3632,0,3632
"Mar 31, 2012",2012,Foreign Letters,40000,0,0,0
"Jul 1, 1991",1991,The Last Waltz,35000,321952,611,322563
"Oct 25, 2013",2013,Her Cry: La Llorona Investigation,35000,0,0,0
"Dec 31, 2014",2014,Happy 40th,35000,0,0,0
"Jul 18, 2008",2008,The Legend of God's Gun,30000,243768,0,243768
"Mar 18, 2016",2016,Krisha,30000,144822,0,144822
"Sep 1, 2006",2006,Mutual Appreciation,30000,103509,0,103509
"Apr 29, 2005",2005,Funny Ha Ha,30000,77070,5628,82698
"Oct 15, 2010",2010,Down Terrace,30000,9812,0,9812
"Dec 31, 2013",2013,Paraphobia,30000,0,0,0
"Oct 19, 1994",1994,Clerks,27000,3073428,820812,3894240
"Dec 24, 1999",1999,Pink Narcissus,27000,8231,0,8231
"Jan 27, 2017",2017,Emily,27000,3547,0,3547
"Jun 30, 1972",1972,Deep Throat,25000,45000000,0,45000000
"Aug 1, 1997",1997,In the Company of Men,25000,2883661,0,2883661
"Jan 14, 2000",2000,The Terrorist,25000,195043,0,195043
"Sep 1, 2015",2015,Exeter,25000,0,489792,489792
"Jun 13, 2003",2003,Manito,25000,0,0,0
"Apr 21, 2015",2015,Ten,25000,0,0,0
"Dec 1, 2015",2015,Dutch Kills,25000,0,0,0
"Aug 1, 1991",1991,Slacker,23000,1227508,0,1227508
"Dec 31, 2014",2014,Dry Spell,22000,0,0,0
"Dec 31, 2003",2003,Flywheel,20000,0,0,0
"Jan 4, 2013",2013,All Superheroes Must Die,20000,0,0,0
"Apr 21, 2015",2015,The Front Man,20000,0,0,0
"Dec 1, 2003",2003,Steel Spirit,20000,0,0,0
"Nov 25, 2011",2011,The Ridges,17300,0,0,0
"Jun 2, 2006",2006,The Puffy Chair,15000,194523,731,195254
"Apr 2, 2010",2010,Breaking Upwards,15000,115592,0,115592
"Dec 31, 2014",2014,Stories of Our Lives,15000,0,0,0
"Apr 11, 1997",1997,Pink Flamingos,12000,413802,0,413802
"Apr 28, 2006",2006,Grip: A Criminal's Story,12000,1336,0,1336
"Dec 31, 2007",2007,Tin Can Man,12000,0,0,0
"Mar 9, 2001",2001,Dayereh,10000,673780,0,673780
"Apr 28, 2006",2006,Clean,10000,138711,0,138711
"Jul 6, 2001",2001,Cure,10000,94596,0,94596
"May 28, 2004",2004,On the Downlow,10000,1987,0,1987
"Apr 1, 1996",1996,Bang,10000,527,0,527
"Aug 14, 2008",2008,The Rise and Fall of Miss Thang,10000,401,0,401
"May 19, 2015",2015,Family Motocross,10000,0,0,0
"Jan 13, 2012",2012,Newlyweds,9000,4584,0,4584
"Feb 26, 1993",1993,El Mariachi,7000,2040920,1008,2041928
"Oct 8, 2004",2004,Primer,7000,424760,417166,841926
"May 26, 2006",2006,Cavite,7000,70071,1573,71644
"Dec 31, 2004",2004,The Mongol King,7000,900,0,900
"Dec 31, 2018",2018,Red 11,7000,0,0,0
"Apr 2, 1999",1999,Following,6000,48482,192013,240495
"Jul 13, 2005",2005,Return to the Land of Wonders,5000,1338,0,1338
"Sep 29, 2015",2015,A Plague So Pleasant,1400,0,0,0
"Aug 5, 2005",2005,My Date With Drew,1100,181041,0,181041
